Date,Dealer Code,Daily Sales ($),Prior MTD ($),Current MTD ($),YoY MTD ($),YoY MTD (%)
2024-01-02,D001,4155,76957,81112,79985,1.41
2024-01-06,D001,5893,93557,99450,97426,2.08
2024-01-08,D001,3624,64178,67802,69526,-2.48
2024-01-08,D001,3612,96971,100583,102896,-2.25
2024-01-11,D001,4849,71226,76075,73316,3.76
2024-01-15,D001,4572,56298,60870,57241,6.34
2024-01-17,D001,4734,63117,67851,63636,6.62
2024-02-08,D001,5640,95242,100882,100215,0.67
2024-02-18,D001,6747,77412,84159,86867,-3.12
2024-02-27,D001,6963,69982,76945,76712,0.3
2024-03-02,D001,4230,59369,63599,62742,1.37
2024-03-02,D001,3464,97361,100825,98060,2.82
2024-03-07,D001,4928,64980,69908,65891,6.1
2024-03-08,D001,5541,78464,84005,86954,-3.39
2024-03-08,D001,6611,90721,97332,95955,1.44
2024-03-12,D001,4110,70389,74499,70070,6.32
2024-03-15,D001,3946,75762,79708,80874,-1.44
2024-03-30,D001,4943,68672,73615,76069,-3.23
2024-04-02,D001,3504,92581,96085,92606,3.76
2024-04-02,D001,3238,82972,86210,86603,-0.45
2024-04-07,D001,5705,72481,78186,75293,3.84
2024-04-11,D001,5082,85634,90716,91470,-0.82
2024-04-12,D001,6348,88892,95240,90403,5.35
2024-04-15,D001,6260,82019,88279,88134,0.16
2024-04-16,D001,6730,55793,62523,61000,2.5
2024-04-16,D001,6303,66061,72364,74482,-2.84
2024-04-26,D001,6736,81899,88635,87888,0.85
2024-05-10,D001,3068,90280,93348,89443,4.37
2024-05-10,D001,5526,95063,100589,102885,-2.23
2024-05-12,D001,5280,66907,72187,72794,-0.83
2024-05-22,D001,3615,59941,63556,62731,1.32
2024-05-26,D001,4310,97055,101365,98592,2.81
2024-06-12,D001,3546,60433,63979,60133,6.4
2024-06-16,D001,6920,95588,102508,97743,4.88
2024-06-19,D001,6098,58066,64164,63267,1.42
2024-06-20,D001,6549,92238,98787,97629,1.19
2024-07-08,D001,3380,65819,69199,70671,-2.08
2024-07-11,D001,5606,94179,99785,96879,3
2024-07-11,D001,6000,51085,57085,52386,8.97
2024-07-16,D001,5094,92723,97817,98013,-0.2
2024-07-27,D001,5810,88784,94594,91334,3.57
2024-07-30,D001,5987,96934,102921,101218,1.68
2024-08-03,D001,6388,81971,88359,89863,-1.67
2024-08-06,D001,5836,97028,102864,104313,-1.39
2024-08-14,D001,6115,60220,66335,67681,-1.99
2024-08-15,D001,3753,55639,59392,60357,-1.6
2024-08-18,D001,3110,98784,101894,103650,-1.69
2024-08-18,D001,4564,56074,60638,61290,-1.06
2024-08-22,D001,5353,92861,98214,95113,3.26
2024-08-26,D001,5548,85897,91445,93224,-1.91
2024-09-05,D001,4284,58254,62538,63008,-0.75
2024-09-05,D001,6262,98617,104879,101042,3.8
2024-09-14,D001,5361,74509,79870,78313,1.99
2024-09-16,D001,4062,81285,85347,81692,4.47
2024-09-23,D001,5520,97025,102545,99251,3.32
2024-09-24,D001,5307,65732,71039,67947,4.55
2024-09-24,D001,3870,96476,100346,102481,-2.08
2024-09-27,D001,6160,75041,81201,77124,5.29
2024-10-04,D001,5401,84540,89941,90981,-1.14
2024-10-08,D001,6764,98542,105306,102393,2.84
2024-10-09,D001,6266,65115,71381,69232,3.1
2024-10-09,D001,4386,66076,70462,66278,6.31
2024-10-17,D001,4855,99652,104507,105274,-0.73
2024-10-18,D001,3024,59764,62788,59644,5.27
2024-10-21,D001,3276,73616,76892,78086,-1.53
2024-10-21,D001,4238,65321,69559,64677,7.55
2024-10-21,D001,5770,53692,59462,58597,1.48
2024-10-30,D001,5903,88973,94876,93481,1.49
2024-10-31,D001,4795,80399,85194,83508,2.02
2024-11-02,D001,6471,86345,92816,92578,0.26
2024-11-03,D001,6818,63273,70091,65162,7.56
2024-11-04,D001,3261,72778,76039,76869,-1.08
2024-11-04,D001,3158,91745,94903,96100,-1.25
2024-11-06,D001,3517,62763,66280,67280,-1.49
2024-11-10,D001,6567,81643,88210,90041,-2.03
2024-11-14,D001,5264,87921,93185,94291,-1.17
2024-11-16,D001,3539,56499,60038,58283,3.01
2024-11-20,D001,3515,77663,81178,81339,-0.2
2024-11-25,D001,4755,57032,61787,57653,7.17
2024-11-25,D001,3852,67921,71773,68608,4.61
2024-11-30,D001,6678,79024,85702,83915,2.13
2024-11-30,D001,4753,67706,72459,69503,4.25
2024-12-02,D001,6010,59689,65699,64845,1.32
2024-12-11,D001,6227,92548,98775,99286,-0.51
2024-12-13,D001,3189,50504,53693,55479,-3.22
2024-12-18,D001,3398,75727,79125,74621,6.04
2024-12-20,D001,4255,62615,66870,68404,-2.24
2024-12-20,D001,3799,94172,97971,96934,1.07
2024-12-29,D001,4284,99666,103950,106502,-2.4
2024-01-03,D002,5743,91232,96975,97048,-0.08
2024-01-04,D002,6209,90166,96375,92632,4.04
2024-01-05,D002,5076,76962,82038,81319,0.88
2024-01-05,D002,5475,86378,91853,90598,1.39
2024-01-05,D002,6164,56569,62733,64242,-2.35
2024-01-06,D002,6641,80020,86661,84130,3.01
2024-01-10,D002,3516,96714,100230,101365,-1.12
2024-01-11,D002,4894,89897,94791,95086,-0.31
2024-01-28,D002,6225,55142,61367,57505,6.72
2024-01-29,D002,3212,74858,78070,73341,6.45
2024-02-01,D002,4129,78363,82492,79348,3.96
2024-02-22,D002,6682,96326,103008,104949,-1.85
2024-03-01,D002,4138,89743,93881,94329,-0.47
2024-03-02,D002,6802,56548,63350,64057,-1.1
2024-03-05,D002,3683,84063,87746,83077,5.62
2024-03-07,D002,4158,62342,66500,65453,1.6
2024-03-14,D002,5510,79661,85171,82944,2.68
2024-03-31,D002,6235,54042,60277,58047,3.84
2024-04-01,D002,5002,55280,60282,59038,2.11
2024-04-09,D002,4425,59732,64157,66627,-3.71
2024-04-13,D002,6854,57263,64117,63623,0.78
2024-04-17,D002,6357,55680,62037,63874,-2.88
2024-04-19,D002,5972,85745,91717,90368,1.49
2024-04-21,D002,4036,69363,73399,69658,5.37
2024-04-21,D002,5574,97372,102946,101225,1.7
2024-04-26,D002,6676,82548,89224,90237,-1.12
2024-05-03,D002,6863,60825,67688,64379,5.14
2024-05-11,D002,3596,56054,59650,61145,-2.45
2024-05-13,D002,5605,64385,69990,72313,-3.21
2024-05-31,D002,4238,79505,83743,84530,-0.93
2024-06-04,D002,4097,65701,69798,69262,0.77
2024-06-06,D002,3464,89015,92479,89302,3.56
2024-06-27,D002,3877,99938,103815,104706,-0.85
2024-07-10,D002,3574,55704,59278,59046,0.39
2024-07-13,D002,3470,61382,64852,63361,2.35
2024-07-28,D002,3125,79163,82288,81708,0.71
2024-07-30,D002,3579,51663,55242,51766,6.71
2024-08-03,D002,6895,58752,65647,65996,-0.53
2024-08-06,D002,6696,51300,57996,58497,-0.86
2024-08-23,D002,4359,65437,69796,72325,-3.5
2024-09-03,D002,6383,81133,87516,89215,-1.9
2024-09-05,D002,6016,68880,74896,71934,4.12
2024-09-05,D002,4134,73645,77779,75250,3.36
2024-09-09,D002,4757,67776,72533,71783,1.04
2024-09-20,D002,5630,86343,91973,94098,-2.26
2024-09-20,D002,4248,76234,80482,78325,2.75
2024-09-27,D002,3898,54234,58132,57368,1.33
2024-09-27,D002,6472,61023,67495,65220,3.49
2024-09-29,D002,5873,51150,57023,53678,6.23
2024-10-05,D002,3316,84270,87586,90166,-2.86
2024-10-07,D002,3883,51212,55095,52398,5.15
2024-10-14,D002,4161,85719,89880,92151,-2.46
2024-10-23,D002,6581,94997,101578,104006,-2.33
2024-11-04,D002,6687,76727,83414,82396,1.24
2024-11-04,D002,4995,74009,79004,81910,-3.55
2024-11-05,D002,4386,69250,73636,71848,2.49
2024-11-06,D002,3738,50545,54283,54822,-0.98
2024-11-08,D002,3078,87538,90616,87783,3.23
2024-11-11,D002,5741,52077,57818,55103,4.93
2024-11-16,D002,4066,55432,59498,56062,6.13
2024-11-16,D002,4458,65995,70453,65610,7.38
2024-11-27,D002,5168,95865,101033,103056,-1.96
2024-11-30,D002,5762,63703,69465,65272,6.42
2024-12-05,D002,5139,73483,78622,80144,-1.9
2024-12-09,D002,3583,79759,83342,82554,0.95
2024-12-11,D002,4268,69249,73517,68824,6.82
2024-12-16,D002,5056,64685,69741,70610,-1.23
2024-12-17,D002,3977,58012,61989,63344,-2.14
2024-12-25,D002,5131,92026,97157,92324,5.23
2024-12-26,D002,5988,62455,68443,69028,-0.85
2024-01-05,D003,5777,60109,65886,66000,-0.17
2024-01-06,D003,4999,88679,93678,93175,0.54
2024-01-11,D003,5865,88394,94259,92745,1.63
2024-01-12,D003,6977,75496,82473,84785,-2.73
2024-01-12,D003,3194,52537,55731,55889,-0.28
2024-01-17,D003,6149,65053,71202,73901,-3.65
2024-01-19,D003,3923,72631,76554,79314,-3.48
2024-01-28,D003,5373,99131,104504,106565,-1.93
2024-02-03,D003,5160,52472,57632,57667,-0.06
2024-02-12,D003,5531,86176,91707,89092,2.94
2024-02-19,D003,4430,98423,102853,103940,-1.05
2024-02-24,D003,6649,60978,67627,67530,0.14
2024-02-25,D003,6111,80561,86672,83489,3.81
2024-02-25,D003,4910,74466,79376,75664,4.91
2024-03-01,D003,6398,99047,105445,105695,-0.24
2024-03-02,D003,5180,72152,77332,72625,6.48
2024-03-02,D003,3386,68584,71970,70256,2.44
2024-03-02,D003,4132,92662,96794,96174,0.64
2024-03-08,D003,6836,94953,101789,102283,-0.48
2024-03-13,D003,5695,60106,65801,63612,3.44
2024-03-15,D003,3556,74323,77879,73046,6.62
2024-03-24,D003,4993,53251,58244,55339,5.25
2024-03-24,D003,5203,57830,63033,62786,0.39
2024-03-27,D003,5354,72353,77707,75434,3.01
2024-03-30,D003,5663,97801,103464,105191,-1.64
2024-04-01,D003,3933,56066,59999,58505,2.55
2024-04-02,D003,4626,86484,91110,88868,2.52
2024-04-12,D003,3992,74118,78110,76246,2.44
2024-04-15,D003,6722,54906,61628,59108,4.26
2024-04-16,D003,4447,74709,79156,77273,2.44
2024-04-22,D003,3797,52846,56643,58714,-3.53
2024-04-23,D003,3061,95929,98990,101671,-2.64
2024-04-23,D003,6855,61254,68109,66419,2.54
2024-04-24,D003,4241,96728,100969,97720,3.32
2024-05-01,D003,4275,78546,82821,79367,4.35
2024-05-10,D003,4260,56901,61161,61376,-0.35
2024-05-13,D003,4742,51306,56048,55199,1.54
2024-05-17,D003,6258,81629,87887,86076,2.1
2024-05-31,D003,5101,62183,67284,65561,2.63
2024-06-01,D003,3638,83765,87403,86327,1.25
2024-06-04,D003,3834,50205,54039,54206,-0.31
2024-06-04,D003,4421,74371,78792,81507,-3.33
2024-06-10,D003,5348,74881,80229,83228,-3.6
2024-06-14,D003,6293,72588,78881,76633,2.93
2024-06-15,D003,5439,57804,63243,61412,2.98
2024-06-22,D003,3345,84654,87999,84528,4.11
2024-06-28,D003,4725,68073,72798,72531,0.37
2024-07-04,D003,6170,79265,85435,80681,5.89
2024-07-11,D003,6966,76681,83647,79043,5.82
2024-07-11,D003,5446,88233,93679,91365,2.53
2024-07-12,D003,3974,55229,59203,54815,8.01
2024-07-12,D003,5355,59860,65215,62189,4.87
2024-07-13,D003,3292,89632,92924,91902,1.11
2024-07-14,D003,4893,69659,74552,73502,1.43
2024-07-20,D003,3754,78706,82460,80920,1.9
2024-07-23,D003,4449,61218,65667,62612,4.88
2024-07-24,D003,3798,63750,67548,66599,1.42
2024-07-25,D003,3947,93401,97348,93160,4.5
2024-07-28,D003,3614,50328,53942,51451,4.84
2024-07-29,D003,6483,59474,65957,68344,-3.49
2024-07-29,D003,5451,50024,55475,52513,5.64
2024-08-05,D003,3910,50306,54216,50641,7.06
2024-08-07,D003,4276,54942,59218,55759,6.2
2024-08-12,D003,3257,88121,91378,90971,0.45
2024-08-29,D003,3298,86302,89600,86756,3.28
2024-09-02,D003,5284,50615,55899,53261,4.95
2024-09-02,D003,3135,54887,58022,57168,1.49
2024-09-05,D003,4097,55950,60047,60121,-0.12
2024-09-11,D003,3327,81480,84807,84497,0.37
2024-09-27,D003,6118,59901,66019,61794,6.84
2024-10-12,D003,6525,94793,101318,99389,1.94
2024-10-17,D003,3761,66312,70073,71637,-2.18
2024-10-17,D003,5836,62638,68474,71295,-3.96
2024-10-17,D003,6240,72970,79210,79507,-0.37
2024-10-19,D003,5514,93292,98806,101206,-2.37
2024-10-19,D003,6956,56641,63597,65656,-3.14
2024-10-26,D003,5428,95113,100541,96115,4.6
2024-11-01,D003,3267,92944,96211,98134,-1.96
2024-11-02,D003,3646,80740,84386,84498,-0.13
2024-11-02,D003,3750,75444,79194,78132,1.36
2024-11-04,D003,5515,84206,89721,88557,1.31
2024-11-09,D003,3215,94214,97429,92693,5.11
2024-11-11,D003,5123,75174,80297,79956,0.43
2024-11-11,D003,5507,65586,71093,69919,1.68
2024-11-19,D003,6064,83455,89519,92210,-2.92
2024-11-20,D003,4125,67269,71394,71553,-0.22
2024-11-24,D003,5659,50255,55914,57412,-2.61
2024-11-25,D003,4959,87865,92824,95376,-2.68
2024-12-01,D003,4497,98359,102856,105161,-2.19
2024-12-02,D003,6646,91520,98166,100067,-1.9
2024-12-04,D003,3169,87693,90862,91117,-0.28
2024-12-11,D003,6985,93813,100798,96032,4.96
2024-12-14,D003,3959,88827,92786,95094,-2.43
2024-12-17,D003,4225,91127,95352,94667,0.72
2024-12-20,D003,4248,78311,82559,79909,3.32
2024-12-22,D003,4708,86693,91401,92493,-1.18
2024-12-25,D003,5733,86631,92364,90643,1.9
2024-12-30,D003,5906,96754,102660,101214,1.43
2024-12-30,D003,3258,50282,53540,50795,5.4
2024-01-04,D004,5440,67550,72990,72415,0.79
2024-01-19,D004,3065,87030,90095,87391,3.09
2024-02-06,D004,5691,61864,67555,68559,-1.46
2024-02-17,D004,4592,98714,103306,99117,4.23
2024-02-19,D004,3284,60832,64116,61731,3.86
2024-02-28,D004,4607,98988,103595,98853,4.8
2024-02-29,D004,4907,52890,57797,57604,0.34
2024-03-05,D004,5642,92137,97779,94675,3.28
2024-03-09,D004,6236,65848,72084,72732,-0.89
2024-03-11,D004,6720,75743,82463,77907,5.85
2024-03-12,D004,3983,97632,101615,98614,3.04
2024-03-15,D004,4503,64342,68845,71480,-3.69
2024-03-15,D004,4937,74605,79542,79328,0.27
2024-03-16,D004,3328,92399,95727,91357,4.78
2024-03-17,D004,6025,69330,75355,70817,6.41
2024-03-19,D004,5832,73147,78979,79993,-1.27
2024-03-22,D004,3753,88328,92081,91065,1.12
2024-03-25,D004,4533,52674,57207,52603,8.75
2024-03-27,D004,3842,76547,80389,79029,1.72
2024-03-30,D004,6416,70829,77245,76715,0.69
2024-03-30,D004,4127,74968,79095,81465,-2.91
2024-04-01,D004,4982,75879,80861,76057,6.32
2024-04-02,D004,5426,74473,79899,79937,-0.05
2024-04-04,D004,3567,99695,103262,99888,3.38
2024-04-09,D004,6921,98014,104935,107117,-2.04
2024-04-13,D004,4506,71727,76233,77378,-1.48
2024-04-13,D004,5383,81390,86773,82809,4.79
2024-04-17,D004,5578,89321,94899,93857,1.11
2024-04-18,D004,6401,94220,100621,98407,2.25
2024-04-21,D004,5743,58039,63782,66776,-4.48
2024-05-04,D004,6153,73834,79987,81281,-1.59
2024-05-05,D004,3174,69194,72368,72276,0.13
2024-05-06,D004,5871,56661,62532,61308,2
2024-05-19,D004,6515,85098,91613,92254,-0.69
2024-05-23,D004,6849,71612,78461,74612,5.16
2024-05-24,D004,6803,96429,103232,102737,0.48
2024-05-26,D004,3489,93485,96974,98792,-1.84
2024-05-26,D004,4790,82980,87770,89112,-1.51
2024-05-28,D004,6175,55581,61756,60942,1.34
2024-06-02,D004,4138,70875,75013,73148,2.55
2024-06-02,D004,4893,80573,85466,81671,4.65
2024-06-06,D004,4780,96579,101359,101946,-0.58
2024-06-09,D004,5686,74995,80681,83088,-2.9
2024-06-12,D004,4029,79171,83200,80420,3.46
2024-06-17,D004,3058,59765,62823,64683,-2.88
2024-06-21,D004,3999,80482,84481,87418,-3.36
2024-06-26,D004,6364,82813,89177,90984,-1.99
2024-06-27,D004,4071,63383,67454,70342,-4.11
2024-06-27,D004,3596,79122,82718,85162,-2.87
2024-06-30,D004,3033,82539,85572,86731,-1.34
2024-07-06,D004,6388,72419,78807,78598,0.27
2024-07-11,D004,5638,67464,73102,69862,4.64
2024-07-15,D004,5692,93978,99670,96272,3.53
2024-07-21,D004,6255,62688,68943,71177,-3.14
2024-07-21,D004,3046,78317,81363,79860,1.88
2024-07-24,D004,3911,70435,74346,69771,6.56
2024-07-26,D004,6541,95771,102312,102289,0.02
2024-07-28,D004,6267,79793,86060,82312,4.55
2024-08-01,D004,3255,91094,94349,93705,0.69
2024-08-10,D004,3079,81282,84361,81784,3.15
2024-08-13,D004,4193,50597,54790,57146,-4.12
2024-08-18,D004,4668,69338,74006,75858,-2.44
2024-08-24,D004,6621,63331,69952,67208,4.08
2024-09-01,D004,4984,53936,58920,55322,6.5
2024-09-02,D004,5436,55769,61205,63898,-4.21
2024-09-07,D004,5371,89836,95207,94907,0.32
2024-09-09,D004,3448,87353,90801,91896,-1.19
2024-09-09,D004,3797,83547,87344,83185,5
2024-09-16,D004,4638,73312,77950,78802,-1.08
2024-09-16,D004,6076,68728,74804,77185,-3.08
2024-09-19,D004,4845,92368,97213,94922,2.41
2024-09-20,D004,5561,66232,71793,66989,7.17
2024-10-01,D004,3723,99376,103099,101472,1.6
2024-10-03,D004,4553,60534,65087,66281,-1.8
2024-10-04,D004,6475,61345,67820,69156,-1.93
2024-10-05,D004,3780,68640,72420,67838,6.75
2024-10-06,D004,6811,63347,70158,66458,5.57
2024-10-06,D004,5899,59638,65537,64094,2.25
2024-10-07,D004,4982,67821,72803,75375,-3.41
2024-10-14,D004,5057,52794,57851,58991,-1.93
2024-10-18,D004,6958,67216,74174,76925,-3.58
2024-10-23,D004,6194,82398,88592,86803,2.06
2024-10-25,D004,6623,67637,74260,69716,6.52
2024-10-28,D004,6002,71770,77772,73830,5.34
2024-11-18,D004,5118,56391,61509,64364,-4.44
2024-11-20,D004,3508,92220,95728,97170,-1.48
2024-11-21,D004,6917,77331,84248,80503,4.65
2024-11-21,D004,5687,80333,86020,86144,-0.14
2024-11-29,D004,4991,82376,87367,85901,1.71
2024-11-29,D004,6373,72821,79194,76118,4.04
2024-12-01,D004,3335,74532,77867,77898,-0.04
2024-12-03,D004,6066,58055,64121,62467,2.65
2024-12-07,D004,4663,98089,102752,103737,-0.95
2024-12-09,D004,4694,60170,64864,67052,-3.26
2024-12-13,D004,4144,82699,86843,87144,-0.35
2024-12-14,D004,6029,57564,63593,63824,-0.36
2024-12-21,D004,6843,52056,58899,54756,7.57
2024-12-25,D004,3634,82543,86177,87778,-1.82
2024-12-31,D004,3690,60040,63730,60589,5.18
2024-12-31,D004,3883,80933,84816,82042,3.38
2024-01-04,D005,6563,95416,101979,103515,-1.48
2024-01-08,D005,6224,63146,69370,72197,-3.92
2024-01-10,D005,4381,58154,62535,64068,-2.39
2024-01-13,D005,3942,74045,77987,79263,-1.61
2024-01-14,D005,3631,59602,63233,61730,2.43
2024-01-20,D005,3389,91669,95058,95440,-0.4
2024-01-25,D005,4847,64569,69416,70760,-1.9
2024-01-25,D005,6724,59175,65899,60997,8.04
2024-02-03,D005,6863,68782,75645,76015,-0.49
2024-02-03,D005,3038,84370,87408,88152,-0.84
2024-02-11,D005,6949,71731,78680,77391,1.67
2024-02-11,D005,6124,91439,97563,97049,0.53
2024-02-13,D005,3717,74893,78610,76981,2.12
2024-02-16,D005,5931,96335,102266,99420,2.86
2024-02-16,D005,6750,75027,81777,78345,4.38
2024-02-27,D005,4129,97915,102044,103691,-1.59
2024-02-28,D005,3264,79004,82268,78937,4.22
2024-03-08,D005,4529,64260,68789,63994,7.49
2024-03-09,D005,4721,82422,87143,84307,3.36
2024-03-10,D005,5672,79546,85218,80939,5.29
2024-03-12,D005,4613,98316,102929,103526,-0.58
2024-03-17,D005,6231,56351,62582,63278,-1.1
2024-03-22,D005,4560,58967,63527,63489,0.06
2024-03-24,D005,3668,81828,85496,85992,-0.58
2024-03-26,D005,5833,67634,73467,73827,-0.49
2024-03-27,D005,5512,88987,94499,90885,3.98
2024-04-01,D005,5559,97191,102750,104262,-1.45
2024-04-03,D005,4904,53959,58863,55534,5.99
2024-04-04,D005,4010,97692,101702,99412,2.3
2024-04-06,D005,4747,66108,70855,67704,4.65
2024-04-08,D005,4370,79680,84050,81993,2.51
2024-04-09,D005,4004,89825,93829,93074,0.81
2024-04-12,D005,4219,50876,55095,57104,-3.52
2024-04-17,D005,4674,61101,65775,60825,8.14
2024-04-18,D005,4019,83440,87459,90021,-2.85
2024-04-22,D005,5011,74188,79199,79696,-0.62
2024-04-27,D005,6076,50443,56519,52000,8.69
2024-05-07,D005,3306,94565,97871,97072,0.82
2024-05-09,D005,6314,96903,103217,105494,-2.16
2024-05-12,D005,3872,71146,75018,76967,-2.53
2024-05-20,D005,3667,53370,57037,54061,5.5
2024-05-21,D005,6835,66991,73826,70657,4.49
2024-05-22,D005,4445,55837,60282,56485,6.72
2024-05-24,D005,6940,99741,106681,105355,1.26
2024-05-26,D005,6942,97469,104411,102130,2.23
2024-05-27,D005,5495,51551,57046,53084,7.46
2024-06-03,D005,4622,71536,76158,74995,1.55
2024-06-04,D005,3756,82615,86371,88267,-2.15
2024-06-09,D005,4008,83997,88005,89970,-2.18
2024-06-11,D005,3274,92678,95952,97852,-1.94
2024-06-15,D005,6706,53657,60363,58517,3.15
2024-06-16,D005,3202,70096,73298,72470,1.14
2024-06-17,D005,5548,54782,60330,59478,1.43
2024-06-20,D005,3908,65123,69031,67346,2.5
2024-06-23,D005,4584,99634,104218,104039,0.17
2024-06-24,D005,6699,76039,82738,82463,0.33
2024-06-25,D005,4305,78804,83109,79432,4.63
2024-06-28,D005,4023,80531,84554,81158,4.18
2024-06-28,D005,5059,94370,99429,99439,-0.01
2024-07-01,D005,3679,53409,57088,59399,-3.89
2024-07-06,D005,6199,91160,97359,97161,0.2
2024-07-07,D005,4746,78402,83148,80351,3.48
2024-07-13,D005,4977,69738,74715,75204,-0.65
2024-07-21,D005,3023,85771,88794,85812,3.48
2024-07-28,D005,6727,63703,70430,69502,1.34
2024-07-29,D005,4984,78832,83816,85538,-2.01
2024-08-01,D005,6279,78840,85119,84718,0.47
2024-08-02,D005,6446,75685,82131,82610,-0.58
2024-08-06,D005,6672,80791,87463,89193,-1.94
2024-08-07,D005,6490,87242,93732,94983,-1.32
2024-08-08,D005,3994,89322,93316,96309,-3.11
2024-08-12,D005,3906,90389,94295,96633,-2.42
2024-08-13,D005,6636,82991,89627,86330,3.82
2024-08-22,D005,3995,57226,61221,63034,-2.88
2024-08-24,D005,4716,83078,87794,84102,4.39
2024-08-29,D005,6372,89619,95991,93887,2.24
2024-08-30,D005,3597,91758,95355,92977,2.56
2024-08-31,D005,6765,54379,61144,60761,0.63
2024-09-03,D005,6332,50787,57119,53897,5.98
2024-09-14,D005,4919,68675,73594,71127,3.47
2024-09-17,D005,3053,57214,60267,62541,-3.64
2024-09-17,D005,5397,60759,66156,63717,3.83
2024-09-19,D005,6936,85788,92724,89658,3.42
2024-09-22,D005,6845,70594,77439,77247,0.25
2024-10-09,D005,4528,63509,68037,63936,6.41
2024-10-20,D005,4505,71113,75618,70657,7.02
2024-10-21,D005,4893,63697,68590,68924,-0.48
2024-10-22,D005,4057,57035,61092,60813,0.46
2024-10-25,D005,3943,71281,75224,71785,4.79
2024-10-27,D005,5053,69675,74728,76710,-2.58
2024-10-29,D005,4944,50009,54953,55082,-0.23
2024-10-31,D005,4377,54381,58758,55287,6.28
2024-11-07,D005,5655,59171,64826,63297,2.42
2024-11-10,D005,4325,61369,65694,64821,1.35
2024-11-15,D005,4180,91627,95807,90989,5.3
2024-11-21,D005,4765,86930,91695,94392,-2.86
2024-11-26,D005,6321,54666,60987,63273,-3.61
2024-11-28,D005,6548,60526,67074,66700,0.56
2024-11-29,D005,5100,88973,94073,89883,4.66
2024-12-01,D005,5702,56441,62143,64650,-3.88
2024-12-02,D005,3505,67513,71018,71939,-1.28
2024-12-16,D005,4668,88757,93425,89511,4.37
2024-12-19,D005,5793,73718,79511,79600,-0.11
2024-12-21,D005,6653,76201,82854,82523,0.4
2024-12-25,D005,4271,91323,95594,96226,-0.66
2024-12-31,D005,5129,96972,102101,99151,2.98
2024-01-01,D006,4006,50406,54412,51915,4.81
2024-01-11,D006,3161,65846,69007,65908,4.7
2024-01-13,D006,6311,51855,58166,55564,4.68
2024-01-18,D006,6081,66475,72556,71322,1.73
2024-01-25,D006,5550,77832,83382,83226,0.19
2024-01-26,D006,4675,53981,58656,60355,-2.82
2024-01-27,D006,5318,87425,92743,88796,4.45
2024-01-30,D006,5406,56038,61444,56989,7.82
2024-02-04,D006,4824,67572,72396,69752,3.79
2024-02-06,D006,5612,75105,80717,77615,4
2024-02-13,D006,3355,94460,97815,99775,-1.96
2024-02-16,D006,5125,98998,104123,100843,3.25
2024-02-22,D006,4473,54300,58773,55504,5.89
2024-02-22,D006,4601,75401,80002,76353,4.78
2024-02-23,D006,4129,90757,94886,96386,-1.56
2024-02-24,D006,6906,87260,94166,95628,-1.53
2024-02-27,D006,6627,95740,102367,98552,3.87
2024-03-03,D006,5341,89807,95148,92723,2.62
2024-03-05,D006,4812,69192,74004,73673,0.45
2024-03-10,D006,5669,73171,78840,79225,-0.49
2024-03-10,D006,4526,56767,61293,61730,-0.71
2024-03-15,D006,4677,52881,57558,55271,4.14
2024-03-17,D006,4016,64523,68539,69658,-1.61
2024-03-18,D006,3859,65545,69404,70525,-1.59
2024-04-04,D006,6861,84753,91614,88554,3.46
2024-04-08,D006,6963,83828,90791,91464,-0.74
2024-04-12,D006,6081,85398,91479,91318,0.18
2024-04-13,D006,3203,67357,70560,66477,6.14
2024-04-17,D006,4274,84707,88981,88028,1.08
2024-04-21,D006,5423,86730,92153,90611,1.7
2024-04-24,D006,5310,63965,69275,66734,3.81
2024-04-27,D006,5245,70684,75929,77180,-1.62
2024-04-28,D006,6896,61294,68190,65553,4.02
2024-04-28,D006,6722,65007,71729,68354,4.94
2024-04-29,D006,3681,64670,68351,67419,1.38
2024-05-07,D006,5579,88871,94450,91920,2.75
2024-05-08,D006,4031,60208,64239,66677,-3.66
2024-05-11,D006,3492,89410,92902,88717,4.72
2024-05-14,D006,5194,57851,63045,64447,-2.18
2024-05-15,D006,4219,99112,103331,102150,1.16
2024-05-16,D006,3317,53748,57065,52673,8.34
2024-05-24,D006,4074,58433,62507,58046,7.69
2024-05-25,D006,5175,76665,81840,79365,3.12
2024-05-26,D006,5231,51051,56282,55249,1.87
2024-05-26,D006,4976,82196,87172,84666,2.96
2024-05-27,D006,4359,77718,82077,81773,0.37
2024-05-29,D006,5847,93880,99727,95220,4.73
2024-06-03,D006,3628,61777,65405,66777,-2.05
2024-06-04,D006,4438,71511,75949,76897,-1.23
2024-06-06,D006,6894,51542,58436,60165,-2.87
2024-06-15,D006,6507,76390,82897,79153,4.73
2024-06-17,D006,5319,62867,68186,69296,-1.6
2024-06-25,D006,5581,65600,71181,68473,3.95
2024-06-26,D006,5039,50009,55048,57788,-4.74
2024-06-29,D006,3915,66738,70653,71022,-0.52
2024-07-01,D006,5996,54111,60107,62997,-4.59
2024-07-09,D006,4914,63751,68665,66359,3.48
2024-07-14,D006,3958,90363,94321,94653,-0.35
2024-07-18,D006,6608,61918,68526,67884,0.95
2024-07-18,D006,5070,50814,55884,58539,-4.54
2024-07-22,D006,5798,88759,94557,95218,-0.69
2024-07-25,D006,3463,68582,72045,72758,-0.98
2024-07-29,D006,6643,66299,72942,68398,6.64
2024-07-29,D006,6119,79309,85428,82046,4.12
2024-07-31,D006,4550,99587,104137,106298,-2.03
2024-08-01,D006,5765,93074,98839,97348,1.53
2024-08-03,D006,3632,52199,55831,52475,6.4
2024-08-05,D006,4985,71868,76853,76081,1.01
2024-08-07,D006,3799,78873,82672,78647,5.12
2024-08-07,D006,5799,69561,75360,72693,3.67
2024-08-16,D006,5113,57115,62228,58707,6
2024-08-17,D006,4392,74489,78881,80638,-2.18
2024-08-21,D006,6711,62391,69102,67241,2.77
2024-08-21,D006,4903,91733,96636,93410,3.45
2024-08-31,D006,5632,73396,79028,77465,2.02
2024-09-03,D006,6503,85312,91815,89293,2.82
2024-09-15,D006,6597,52555,59152,61063,-3.13
2024-09-16,D006,3298,77484,80782,79645,1.43
2024-09-23,D006,4356,51022,55378,50431,9.81
2024-09-30,D006,3848,79541,83389,86153,-3.21
2024-10-03,D006,4447,63338,67785,68224,-0.64
2024-10-08,D006,3885,75600,79485,77667,2.34
2024-10-10,D006,4051,96699,100750,100123,0.63
2024-10-11,D006,6197,51462,57659,54691,5.43
2024-10-14,D006,4641,69601,74242,73388,1.16
2024-10-16,D006,3719,67906,71625,67869,5.53
2024-10-21,D006,3754,67778,71532,70251,1.82
2024-11-02,D006,5036,60473,65509,63015,3.96
2024-11-04,D006,6215,92244,98459,100875,-2.4
2024-11-06,D006,3992,51041,55033,51106,7.68
2024-11-07,D006,6282,67081,73363,74184,-1.11
2024-11-23,D006,3227,85096,88323,88592,-0.3
2024-11-26,D006,5530,50131,55661,57545,-3.27
2024-11-26,D006,5296,89932,95228,95631,-0.42
2024-11-26,D006,5391,61228,66619,68849,-3.24
2024-12-05,D006,6940,72867,79807,82604,-3.39
2024-12-09,D006,6333,90218,96551,96654,-0.11
2024-12-12,D006,3648,54340,57988,58832,-1.43
2024-12-14,D006,4794,99811,104605,104794,-0.18
2024-12-16,D006,5146,96246,101392,100511,0.88
2024-12-18,D006,5397,91069,96466,95912,0.58
2024-12-19,D006,6383,88023,94406,95521,-1.17
2024-12-21,D006,3215,98075,101290,101688,-0.39
2024-12-22,D006,6896,92633,99529,99802,-0.27
2024-12-23,D006,4806,51222,56028,56554,-0.93
2024-12-29,D006,5513,60482,65995,63386,4.12
2024-01-01,D007,3560,63407,66967,69255,-3.3
2024-01-01,D007,5619,89161,94780,93033,1.88
2024-01-03,D007,4646,67302,71948,72151,-0.28
2024-01-06,D007,5541,60108,65649,65289,0.55
2024-01-07,D007,4159,54626,58785,54729,7.41
2024-01-07,D007,3196,88957,92153,88480,4.15
2024-01-08,D007,4613,53907,58520,61244,-4.45
2024-01-15,D007,3838,69880,73718,74905,-1.58
2024-01-16,D007,6510,99997,106507,104543,1.88
2024-01-17,D007,3433,89199,92632,89595,3.39
2024-01-22,D007,4500,91802,96302,91695,5.02
2024-01-28,D007,3562,78138,81700,82211,-0.62
2024-02-01,D007,6376,56412,62788,65375,-3.96
2024-02-15,D007,5349,89779,95128,91073,4.45
2024-02-16,D007,3564,69642,73206,73609,-0.55
2024-02-19,D007,4455,68771,73226,73832,-0.82
2024-02-23,D007,3615,74405,78020,75051,3.96
2024-03-20,D007,4258,63598,67856,67990,-0.2
2024-03-22,D007,4395,78264,82659,85060,-2.82
2024-03-24,D007,3207,50899,54106,53645,0.86
2024-03-29,D007,5772,53726,59498,55266,7.66
2024-04-01,D007,3112,62546,65658,66504,-1.27
2024-04-03,D007,3809,65754,69563,71475,-2.68
2024-04-06,D007,3512,50215,53727,49428,8.7
2024-04-12,D007,4957,69540,74497,74109,0.52
2024-04-16,D007,3579,68047,71626,71262,0.51
2024-04-17,D007,3820,51421,55241,50802,8.74
2024-04-21,D007,3047,79047,82094,84267,-2.58
2024-04-23,D007,6604,94179,100783,96883,4.03
2024-04-25,D007,4075,57543,61618,57056,8
2024-05-09,D007,4781,82567,87348,89777,-2.71
2024-05-12,D007,6041,81029,87070,84378,3.19
2024-06-02,D007,3551,57812,61363,59863,2.51
2024-06-03,D007,5126,93901,99027,94378,4.93
2024-06-06,D007,4868,74555,79423,78933,0.62
2024-06-08,D007,4546,59160,63706,64069,-0.57
2024-06-09,D007,3537,99452,102989,105266,-2.16
2024-06-11,D007,4974,69675,74649,77380,-3.53
2024-06-20,D007,6158,70008,76166,73924,3.03
2024-06-21,D007,6472,85737,92209,92181,0.03
2024-06-21,D007,3874,56344,60218,63002,-4.42
2024-06-26,D007,3947,70505,74452,70899,5.01
2024-06-28,D007,3709,69956,73665,70690,4.21
2024-06-29,D007,6398,52155,58553,55587,5.34
2024-07-02,D007,3659,68506,72165,71346,1.15
2024-07-09,D007,4902,62205,67107,65437,2.55
2024-07-14,D007,5873,73116,78989,75315,4.88
2024-07-15,D007,3057,59684,62741,63070,-0.52
2024-07-22,D007,4986,58126,63112,65234,-3.25
2024-07-24,D007,6484,54434,60918,63260,-3.7
2024-07-24,D007,6134,98200,104334,104524,-0.18
2024-07-25,D007,5903,65536,71439,73033,-2.18
2024-07-27,D007,4471,52941,57412,54717,4.93
2024-07-28,D007,4983,59399,64382,65934,-2.35
2024-08-03,D007,6582,56212,62794,58546,7.26
2024-08-06,D007,4556,54175,58731,55788,5.28
2024-08-19,D007,3288,72785,76073,74448,2.18
2024-08-19,D007,6164,99999,106163,104454,1.64
2024-09-05,D007,5475,99731,105206,100532,4.65
2024-09-07,D007,5809,87657,93466,91627,2.01
2024-09-08,D007,4380,85950,90330,88543,2.02
2024-09-09,D007,3256,93390,96646,99205,-2.58
2024-09-19,D007,3305,89469,92774,92479,0.32
2024-09-25,D007,4348,65810,70158,68032,3.12
2024-09-26,D007,6830,87899,94729,91743,3.25
2024-09-27,D007,4759,76250,81009,83218,-2.65
2024-09-27,D007,3745,58749,62494,59287,5.41
2024-09-27,D007,6131,79991,86122,81488,5.69
2024-09-28,D007,3896,50370,54266,49550,9.52
2024-10-07,D007,4963,92745,97708,98434,-0.74
2024-10-10,D007,5029,79400,84429,80216,5.25
2024-10-15,D007,4054,91340,95394,93007,2.57
2024-10-16,D007,6503,67675,74178,74980,-1.07
2024-10-23,D007,6027,88921,94948,91359,3.93
2024-10-28,D007,3766,74094,77860,73378,6.11
2024-11-01,D007,5801,79057,84858,86532,-1.93
2024-11-10,D007,6266,57008,63274,60343,4.86
2024-11-17,D007,5269,66445,71714,73220,-2.06
2024-11-23,D007,4238,55983,60221,60427,-0.34
2024-11-27,D007,4235,63149,67384,64566,4.36
2024-12-13,D007,5587,83539,89126,86601,2.92
2024-12-16,D007,6179,98713,104892,102734,2.1
2024-12-20,D007,5625,69278,74903,70407,6.39
2024-12-21,D007,4816,50394,55210,51767,6.65
2024-12-25,D007,3600,74512,78112,80235,-2.65
2024-12-30,D007,5949,79714,85663,87045,-1.59
2024-12-31,D007,5788,69377,75165,77079,-2.48
2024-01-03,D008,4679,65901,70580,73344,-3.77
2024-01-03,D008,5240,96664,101904,103466,-1.51
2024-01-03,D008,4051,59596,63647,66491,-4.28
2024-01-07,D008,6929,77215,84144,80715,4.25
2024-01-08,D008,5169,58531,63700,62430,2.03
2024-01-10,D008,6010,88428,94438,92560,2.03
2024-01-13,D008,3724,56766,60490,62503,-3.22
2024-01-18,D008,3056,80831,83887,86883,-3.45
2024-01-19,D008,4832,60777,65609,63462,3.38
2024-01-25,D008,6150,96659,102809,98469,4.41
2024-01-29,D008,3295,73513,76808,74787,2.7
2024-01-31,D008,6658,65596,72254,70320,2.75
2024-01-31,D008,4525,61284,65809,63456,3.71
2024-02-01,D008,6283,93442,99725,97333,2.46
2024-02-01,D008,5007,56683,61690,58853,4.82
2024-02-03,D008,5044,56834,61878,64121,-3.5
2024-02-07,D008,6395,63515,69910,67619,3.39
2024-02-08,D008,5201,99401,104602,106929,-2.18
2024-02-10,D008,4391,77794,82185,80978,1.49
2024-02-11,D008,4471,65374,69845,67103,4.09
2024-02-14,D008,6285,95671,101956,104762,-2.68
2024-02-21,D008,4068,60532,64600,60519,6.74
2024-02-25,D008,5624,56411,62035,58823,5.46
2024-02-26,D008,5345,74161,79506,78274,1.57
2024-03-04,D008,5685,78377,84062,83195,1.04
2024-03-12,D008,4690,65549,70239,67852,3.52
2024-03-14,D008,3253,53089,56342,53292,5.72
2024-03-19,D008,3386,71181,74567,70865,5.22
2024-03-26,D008,6416,78155,84571,81802,3.39
2024-03-27,D008,5090,86224,91314,86526,5.53
2024-03-28,D008,6091,79685,85776,86715,-1.08
2024-03-31,D008,5837,77236,83073,78751,5.49
2024-04-02,D008,6993,65305,72298,73673,-1.87
2024-04-07,D008,3824,85694,89518,91166,-1.81
2024-04-19,D008,6021,75537,81558,81569,-0.01
2024-04-19,D008,5400,86775,92175,93270,-1.17
2024-05-01,D008,4371,86487,90858,91113,-0.28
2024-05-05,D008,6510,72290,78800,75674,4.13
2024-05-06,D008,5924,67349,73273,70157,4.44
2024-05-07,D008,5415,50366,55781,51326,8.68
2024-05-14,D008,4218,70880,75098,73363,2.36
2024-05-17,D008,3815,86534,90349,90427,-0.09
2024-05-19,D008,5457,72554,78011,77911,0.13
2024-05-26,D008,6646,98933,105579,103137,2.37
2024-05-28,D008,3789,96353,100142,97317,2.9
2024-05-29,D008,6883,80137,87020,86401,0.72
2024-06-09,D008,6649,95853,102502,105264,-2.62
2024-06-16,D008,3992,98876,102868,104240,-1.32
2024-06-18,D008,5251,95609,100860,97704,3.23
2024-06-22,D008,6014,59157,65171,63112,3.26
2024-06-30,D008,4897,80805,85702,85164,0.63
2024-07-01,D008,3833,93724,97557,98086,-0.54
2024-07-08,D008,6560,57482,64042,66747,-4.05
2024-07-09,D008,4965,90084,95049,91307,4.1
2024-07-23,D008,5362,85524,90886,87033,4.43
2024-07-24,D008,3384,93388,96772,92528,4.59
2024-07-25,D008,5654,59076,64730,63925,1.26
2024-07-25,D008,5993,55350,61343,63810,-3.87
2024-07-28,D008,4755,82335,87090,82423,5.66
2024-07-29,D008,3366,86509,89875,87186,3.08
2024-08-01,D008,5072,97858,102930,99842,3.09
2024-08-06,D008,5953,94941,100894,97961,2.99
2024-08-10,D008,3002,90958,93960,92011,2.12
2024-08-13,D008,5232,85779,91011,89885,1.25
2024-08-13,D008,5407,71248,76655,74763,2.53
2024-08-18,D008,5055,53515,58570,59195,-1.06
2024-08-28,D008,3271,94602,97873,96787,1.12
2024-09-04,D008,4124,97805,101929,104834,-2.77
2024-09-06,D008,3587,52121,55708,55126,1.06
2024-09-07,D008,5938,52483,58421,57180,2.17
2024-09-17,D008,4789,70750,75539,78417,-3.67
2024-09-20,D008,3314,61737,65051,66917,-2.79
2024-09-21,D008,6547,82333,88880,84828,4.78
2024-09-23,D008,3213,53762,56975,54768,4.03
2024-09-27,D008,5928,80276,86204,83969,2.66
2024-10-01,D008,3491,87690,91181,89135,2.3
2024-10-02,D008,6911,59032,65943,65801,0.22
2024-10-03,D008,4335,85629,89964,88314,1.87
2024-10-04,D008,3105,79190,82295,83354,-1.27
2024-10-07,D008,5605,64408,70013,67028,4.45
2024-10-07,D008,5892,51695,57587,57329,0.45
2024-10-11,D008,4203,62952,67155,67362,-0.31
2024-10-14,D008,4792,82016,86808,86744,0.07
2024-10-21,D008,3234,85490,88724,87068,1.9
2024-10-22,D008,3235,60295,63530,64588,-1.64
2024-10-24,D008,6044,72024,78068,75156,3.87
2024-10-24,D008,3857,73154,77011,78962,-2.47
2024-11-01,D008,4932,74078,79010,75814,4.22
2024-11-03,D008,4670,63003,67673,68376,-1.03
2024-11-06,D008,6446,71545,77991,76363,2.13
2024-11-07,D008,3707,94066,97773,100395,-2.61
2024-11-08,D008,4725,81891,86616,86203,0.48
2024-11-13,D008,5232,75805,81037,82470,-1.74
2024-11-14,D008,5527,55088,60615,56051,8.14
2024-11-20,D008,3388,75192,78580,73930,6.29
2024-11-25,D008,4808,84550,89358,87817,1.75
2024-12-06,D008,3128,91974,95102,96303,-1.25
2024-12-08,D008,6087,88220,94307,94041,0.28
2024-12-10,D008,3813,80659,84472,80528,4.9
2024-12-12,D008,5357,81105,86462,82086,5.33
2024-12-17,D008,5019,95550,100569,97844,2.79
2024-12-22,D008,6829,64779,71608,72720,-1.53
2024-12-23,D008,6019,73959,79978,82311,-2.83
2024-12-25,D008,4091,57006,61097,60614,0.8
2024-12-27,D008,6257,86495,92752,88001,5.4
2024-01-03,D009,5132,78441,83573,80102,4.33
2024-01-04,D009,4099,82584,86683,89607,-3.26
2024-01-10,D009,4596,99133,103729,104120,-0.38
2024-01-15,D009,3515,95246,98761,100570,-1.8
2024-01-15,D009,3036,91598,94634,93934,0.75
2024-01-23,D009,6807,78527,85334,80897,5.48
2024-01-24,D009,4038,67059,71097,67429,5.44
2024-01-26,D009,3520,66393,69913,67834,3.06
2024-01-27,D009,6031,66220,72251,70051,3.14
2024-01-29,D009,6727,75236,81963,82340,-0.46
2024-02-08,D009,4563,67154,71717,71562,0.22
2024-02-11,D009,3769,96275,100044,99069,0.98
2024-02-14,D009,5291,75357,80648,76881,4.9
2024-02-21,D009,6711,89963,96674,92954,4
2024-03-08,D009,4933,67764,72697,72016,0.95
2024-03-09,D009,6516,80858,87374,88484,-1.25
2024-03-11,D009,4711,75801,80512,78145,3.03
2024-03-14,D009,6619,68020,74639,74056,0.79
2024-03-16,D009,4570,55415,59985,59594,0.66
2024-03-19,D009,6123,75473,81596,77532,5.24
2024-03-20,D009,6225,73397,79622,74918,6.28
2024-03-26,D009,3022,56086,59108,55725,6.07
2024-03-27,D009,6441,54784,61225,58464,4.72
2024-04-01,D009,3436,54924,58360,54283,7.51
2024-04-02,D009,4685,67818,72503,69222,4.74
2024-04-09,D009,4681,80728,85409,80668,5.88
2024-04-10,D009,6315,53651,59966,60727,-1.25
2024-04-11,D009,4872,61346,66218,61495,7.68
2024-04-14,D009,5047,80869,85916,88771,-3.22
2024-04-18,D009,6968,52716,59684,62494,-4.5
2024-04-18,D009,4160,56297,60457,62046,-2.56
2024-05-02,D009,6380,78343,84723,83953,0.92
2024-05-08,D009,6113,87344,93457,93480,-0.02
2024-05-18,D009,6551,62297,68848,69075,-0.33
2024-05-19,D009,6190,68830,75020,74115,1.22
2024-05-20,D009,4703,66182,70885,73265,-3.25
2024-05-24,D009,3068,85897,88965,85125,4.51
2024-05-29,D009,5463,90388,95851,96077,-0.24
2024-06-01,D009,6808,88014,94822,97630,-2.88
2024-06-12,D009,3082,51920,55002,50185,9.6
2024-06-14,D009,4482,84773,89255,90239,-1.09
2024-06-15,D009,4795,66626,71421,70336,1.54
2024-06-27,D009,5259,92788,98047,99790,-1.75
2024-06-29,D009,4592,65479,70071,69180,1.29
2024-07-05,D009,3875,77399,81274,77369,5.05
2024-07-07,D009,3463,97482,100945,102920,-1.92
2024-07-08,D009,4885,89828,94713,89869,5.39
2024-07-09,D009,6944,59415,66359,66466,-0.16
2024-07-11,D009,5895,92641,98536,100203,-1.66
2024-07-16,D009,6165,72222,78387,75321,4.07
2024-07-18,D009,4278,63490,67768,68174,-0.6
2024-07-19,D009,5343,87904,93247,90487,3.05
2024-07-21,D009,4432,68901,73333,73476,-0.19
2024-07-31,D009,4583,56704,61287,56299,8.86
2024-08-18,D009,3873,81100,84973,87882,-3.31
2024-08-23,D009,3709,69355,73064,73332,-0.37
2024-08-26,D009,6405,59106,65511,67073,-2.33
2024-08-28,D009,6225,97996,104221,100561,3.64
2024-08-28,D009,6347,53675,60022,58307,2.94
2024-09-02,D009,4881,85847,90728,87433,3.77
2024-09-05,D009,5996,59416,65412,61186,6.91
2024-09-06,D009,5361,84660,90021,89582,0.49
2024-09-07,D009,4454,84635,89089,84624,5.28
2024-09-14,D009,4503,90823,95326,95077,0.26
2024-09-18,D009,6144,76015,82159,84607,-2.89
2024-10-05,D009,3713,66508,70221,69975,0.35
2024-10-09,D009,3272,61179,64451,63363,1.72
2024-10-10,D009,3717,82307,86024,84078,2.31
2024-10-11,D009,3076,70538,73614,70040,5.1
2024-10-13,D009,5497,94349,99846,102828,-2.9
2024-10-13,D009,4862,59096,63958,59522,7.45
2024-10-18,D009,6631,55938,62569,61377,1.94
2024-10-23,D009,5409,84229,89638,86368,3.79
2024-10-31,D009,6960,73895,80855,82892,-2.46
2024-11-04,D009,6516,63621,70137,66317,5.76
2024-11-19,D009,4058,59168,63226,61649,2.56
2024-11-25,D009,5448,64385,69833,70042,-0.3
2024-12-05,D009,5348,82577,87925,83214,5.66
2024-12-17,D009,3559,95800,99359,96797,2.65
2024-12-21,D009,3687,58521,62208,63462,-1.98
2024-12-31,D009,4138,61934,66072,67495,-2.11
2024-01-04,D010,5910,53985,59895,57952,3.35
2024-01-29,D010,4384,72689,77073,73061,5.49
2024-01-31,D010,6092,87594,93686,93022,0.71
2024-02-07,D010,6694,63279,69973,66462,5.28
2024-02-10,D010,4502,84178,88680,87910,0.88
2024-02-13,D010,5933,57087,63020,60942,3.41
2024-02-18,D010,5830,80162,85992,82264,4.53
2024-02-20,D010,3860,83061,86921,87233,-0.36
2024-02-22,D010,5861,64088,69949,70928,-1.38
2024-02-22,D010,4067,52100,56167,55510,1.18
2024-02-23,D010,4299,71534,75833,77675,-2.37
2024-03-07,D010,4443,94645,99088,101457,-2.33
2024-03-09,D010,5824,51211,57035,59806,-4.63
2024-03-20,D010,5693,65562,71255,70166,1.55
2024-03-29,D010,6731,66835,73566,74091,-0.71
2024-04-04,D010,3261,76424,79685,77693,2.56
2024-04-07,D010,6416,64114,70530,73323,-3.81
2024-04-11,D010,4357,54893,59250,60966,-2.81
2024-04-19,D010,5893,80564,86457,81632,5.91
2024-04-21,D010,4886,61542,66428,68378,-2.85
2024-04-29,D010,4672,74363,79035,76109,3.84
2024-04-29,D010,3975,75298,79273,79703,-0.54
2024-04-29,D010,6706,92230,98936,94409,4.8
2024-05-02,D010,5263,76913,82176,84732,-3.02
2024-05-04,D010,6771,70733,77504,73402,5.59
2024-05-04,D010,4104,64820,68924,69225,-0.43
2024-05-07,D010,3723,57991,61714,57467,7.39
2024-05-08,D010,3255,73461,76716,75390,1.76
2024-05-09,D010,5241,85131,90372,85420,5.8
2024-05-10,D010,3389,88230,91619,89751,2.08
2024-05-13,D010,5365,57044,62409,59912,4.17
2024-05-14,D010,6528,51624,58152,53491,8.71
2024-05-19,D010,4617,67044,71661,69137,3.65
2024-05-29,D010,5605,56256,61861,57603,7.39
2024-06-05,D010,6902,84120,91022,92426,-1.52
2024-06-12,D010,4504,98022,102526,99471,3.07
2024-06-15,D010,4270,76465,80735,76025,6.2
2024-06-19,D010,4872,63100,67972,70611,-3.74
2024-06-20,D010,4942,67601,72543,72323,0.3
2024-06-23,D010,4001,67430,71431,66478,7.45
2024-06-30,D010,6176,54008,60184,59680,0.84
2024-07-02,D010,6704,91803,98507,99983,-1.48
2024-07-05,D010,4963,85297,90260,88243,2.29
2024-07-07,D010,3650,99445,103095,104238,-1.1
2024-07-17,D010,4787,51073,55860,57695,-3.18
2024-07-19,D010,5203,68839,74042,74208,-0.22
2024-07-19,D010,3829,73897,77726,74100,4.89
2024-07-20,D010,3343,55972,59315,54625,8.59
2024-07-25,D010,5435,74031,79466,80652,-1.47
2024-07-26,D010,4645,88599,93244,93245,0
2024-08-04,D010,5478,92735,98213,99247,-1.04
2024-08-06,D010,3716,93730,97446,96074,1.43
2024-08-11,D010,4046,56800,60846,63737,-4.54
2024-08-12,D010,6742,78363,85105,81313,4.66
2024-08-16,D010,4369,75965,80334,81334,-1.23
2024-08-26,D010,6379,98673,105052,105634,-0.55
2024-09-02,D010,3271,68414,71685,70187,2.13
2024-09-02,D010,6908,81843,88751,88902,-0.17
2024-09-06,D010,5921,54676,60597,59556,1.75
2024-09-07,D010,6878,90902,97780,99856,-2.08
2024-09-10,D010,4540,53956,58496,54943,6.47
2024-09-23,D010,5917,67221,73138,68592,6.63
2024-09-27,D010,5089,67500,72589,67725,7.18
2024-09-29,D010,6568,97664,104232,100605,3.61
2024-10-05,D010,4666,70895,75561,76366,-1.05
2024-10-10,D010,4400,94698,99098,97755,1.37
2024-10-11,D010,3501,74143,77644,76769,1.14
2024-10-13,D010,4339,73365,77704,75312,3.18
2024-10-16,D010,3042,96665,99707,95702,4.18
2024-10-24,D010,5367,62413,67780,70504,-3.86
2024-10-28,D010,5870,91901,97771,96857,0.94
2024-10-29,D010,4080,59777,63857,63800,0.09
2024-10-30,D010,5590,91252,96842,98199,-1.38
2024-11-01,D010,3741,72490,76231,74316,2.58
2024-11-04,D010,6150,98442,104592,102835,1.71
2024-11-08,D010,4176,84103,88279,85866,2.81
2024-11-08,D010,3116,82409,85525,83493,2.43
2024-11-13,D010,5304,78176,83480,83137,0.41
2024-11-16,D010,6113,62884,68997,69557,-0.81
2024-11-26,D010,5317,86389,91706,90215,1.65
2024-12-01,D010,6471,84782,91253,92612,-1.47
2024-12-04,D010,5584,82835,88419,89823,-1.56
2024-12-04,D010,3832,56982,60814,56387,7.85
2024-12-22,D010,5504,85735,91239,87904,3.79
2024-12-27,D010,4139,93169,97308,92562,5.13
2024-12-29,D010,5526,62852,68378,64764,5.58
2024-01-04,D011,4870,91605,96475,99358,-2.9
2024-01-05,D011,3976,51207,55183,53044,4.03
2024-01-06,D011,6092,61154,67246,67584,-0.5
2024-01-10,D011,6778,83397,90175,92906,-2.94
2024-01-21,D011,6622,67509,74131,74014,0.16
2024-01-23,D011,3805,85133,88938,86935,2.3
2024-02-03,D011,4894,93203,98097,99231,-1.14
2024-02-10,D011,3104,96980,100084,101171,-1.07
2024-02-13,D011,6541,58680,65221,63945,2
2024-02-23,D011,4367,54042,58409,55212,5.79
2024-03-01,D011,3945,77586,81531,80630,1.12
2024-03-02,D011,5525,81007,86532,84739,2.12
2024-03-14,D011,3186,51597,54783,54375,0.75
2024-03-21,D011,3391,63986,67377,65863,2.3
2024-03-21,D011,6455,92642,99097,101803,-2.66
2024-03-25,D011,3166,77007,80173,80658,-0.6
2024-03-25,D011,5452,90149,95601,93821,1.9
2024-04-06,D011,3146,90117,93263,91087,2.39
2024-04-08,D011,4302,91168,95470,93734,1.85
2024-04-08,D011,5532,61772,67304,62839,7.11
2024-04-12,D011,4265,88101,92366,94883,-2.65
2024-04-12,D011,6754,97966,104720,101304,3.37
2024-04-14,D011,3951,73874,77825,78143,-0.41
2024-04-17,D011,3025,93964,96989,95473,1.59
2024-04-22,D011,4443,92405,96848,95649,1.25
2024-04-22,D011,3132,84898,88030,84830,3.77
2024-04-28,D011,4734,80608,85342,83781,1.86
2024-04-29,D011,5293,50244,55537,58517,-5.09
2024-05-03,D011,6380,50739,57119,58574,-2.48
2024-05-16,D011,4881,57041,61922,62539,-0.99
2024-05-17,D011,4391,86282,90673,88720,2.2
2024-05-19,D011,5888,79697,85585,86018,-0.5
2024-05-22,D011,6871,99429,106300,109068,-2.54
2024-05-23,D011,6414,60939,67353,69719,-3.39
2024-05-24,D011,3875,58389,62264,64296,-3.16
2024-05-26,D011,3034,59190,62224,59796,4.06
2024-05-26,D011,3906,67740,71646,72472,-1.14
2024-06-07,D011,6036,79823,85859,80990,6.01
2024-06-13,D011,4216,80216,84432,79864,5.72
2024-06-25,D011,6082,97656,103738,100149,3.58
2024-06-30,D011,3892,94799,98691,96022,2.78
2024-07-05,D011,5964,54594,60558,62609,-3.28
2024-07-09,D011,5923,94491,100414,99508,0.91
2024-07-12,D011,3122,78295,81417,82981,-1.88
2024-07-20,D011,5986,91018,97004,97571,-0.58
2024-07-23,D011,3448,71921,75369,70553,6.83
2024-07-24,D011,6750,85062,91812,91182,0.69
2024-07-30,D011,5173,78060,83233,84711,-1.74
2024-08-01,D011,4617,85298,89915,89582,0.37
2024-08-02,D011,5415,72578,77993,77024,1.26
2024-08-03,D011,3981,96015,99996,97385,2.68
2024-08-16,D011,6345,65357,71702,74141,-3.29
2024-08-16,D011,3303,83853,87156,83443,4.45
2024-09-04,D011,4589,84464,89053,89060,-0.01
2024-09-10,D011,4865,93879,98744,99147,-0.41
2024-09-12,D011,3597,70714,74311,75943,-2.15
2024-09-15,D011,3425,99157,102582,105392,-2.67
2024-09-17,D011,6184,54959,61143,63084,-3.08
2024-09-17,D011,3689,71527,75216,73434,2.43
2024-09-20,D011,3224,77606,80830,76958,5.03
2024-09-23,D011,6591,78342,84933,85406,-0.55
2024-09-27,D011,4644,79299,83943,86340,-2.78
2024-09-28,D011,3240,58378,61618,62737,-1.78
2024-10-05,D011,3737,88968,92705,95526,-2.95
2024-10-13,D011,3432,94527,97959,99961,-2
2024-10-14,D011,5092,77452,82544,79203,4.22
2024-10-20,D011,5657,79098,84755,84409,0.41
2024-10-20,D011,3385,58070,61455,61174,0.46
2024-10-24,D011,4908,58881,63789,64167,-0.59
2024-10-27,D011,3728,70581,74309,73813,0.67
2024-10-30,D011,5548,85618,91166,87425,4.28
2024-11-16,D011,4072,82430,86502,82795,4.48
2024-11-21,D011,6964,53990,60954,58744,3.76
2024-11-21,D011,5195,97458,102653,102346,0.3
2024-11-24,D011,3589,59982,63571,65795,-3.38
2024-11-24,D011,6877,77071,83948,81334,3.21
2024-11-26,D011,6596,86807,93403,95099,-1.78
2024-11-30,D011,6593,96698,103291,105181,-1.8
2024-12-08,D011,4400,79825,84225,83154,1.29
2024-12-09,D011,6911,98671,105582,106990,-1.32
2024-12-13,D011,4461,97080,101541,97159,4.51
2024-12-17,D011,6451,50666,57117,59841,-4.55
2024-12-20,D011,6655,74322,80977,83068,-2.52
2024-12-21,D011,5892,97362,103254,102510,0.73
2024-12-25,D011,3834,82214,86048,86226,-0.21
2024-12-26,D011,4739,98688,103427,98669,4.82
2024-12-29,D011,4899,68888,73787,74015,-0.31
2024-12-29,D011,4959,61413,66372,62569,6.08
2024-12-30,D011,4255,54553,58808,55290,6.36
2024-01-04,D012,5045,80535,85580,81477,5.04
2024-01-07,D012,3028,94064,97092,92279,5.22
2024-01-10,D012,5541,59449,64990,60525,7.38
2024-01-13,D012,4143,55065,59208,55712,6.28
2024-01-16,D012,5059,59290,64349,67138,-4.15
2024-01-16,D012,3719,97658,101377,97861,3.59
2024-01-17,D012,6785,95531,102316,101734,0.57
2024-01-29,D012,5690,70953,76643,76899,-0.33
2024-01-30,D012,4337,87861,92198,89962,2.49
2024-02-02,D012,6119,85222,91341,90696,0.71
2024-02-05,D012,4149,99214,103363,101424,1.91
2024-02-05,D012,4440,81770,86210,86176,0.04
2024-02-06,D012,4183,57158,61341,62285,-1.52
2024-02-07,D012,4234,56587,60821,58375,4.19
2024-02-21,D012,3128,81376,84504,84306,0.23
2024-03-01,D012,3761,80505,84266,79574,5.9
2024-03-01,D012,5297,70445,75742,75576,0.22
2024-03-07,D012,5901,96571,102472,105279,-2.67
2024-03-12,D012,4668,93113,97781,93906,4.13
2024-03-14,D012,3007,83243,86250,83834,2.88
2024-03-18,D012,5482,53679,59161,57248,3.34
2024-03-19,D012,3584,60150,63734,62725,1.61
2024-03-24,D012,6414,65005,71419,73110,-2.31
2024-03-24,D012,6087,90399,96486,92260,4.58
2024-03-27,D012,6595,51560,58155,55735,4.34
2024-04-02,D012,3687,96598,100285,101993,-1.67
2024-04-06,D012,3516,60808,64324,61281,4.97
2024-04-12,D012,5990,69394,75384,73665,2.33
2024-04-15,D012,5180,88507,93687,92414,1.38
2024-04-17,D012,3667,73121,76788,77152,-0.47
2024-04-23,D012,6182,84552,90734,90224,0.57
2024-04-29,D012,6654,58720,65374,65050,0.5
2024-05-05,D012,6636,76500,83136,78686,5.66
2024-05-07,D012,4722,83484,88206,84977,3.8
2024-05-08,D012,4081,79305,83386,85874,-2.9
2024-05-10,D012,6308,83297,89605,88982,0.7
2024-05-12,D012,3834,56794,60628,63508,-4.53
2024-05-12,D012,3303,61556,64859,64837,0.03
2024-05-18,D012,3356,89954,93310,90208,3.44
2024-05-26,D012,6928,74241,81169,76175,6.56
2024-05-30,D012,3020,53325,56345,53138,6.04
2024-06-01,D012,6650,66473,73123,70232,4.12
2024-06-08,D012,4952,97561,102513,103782,-1.22
2024-06-21,D012,3129,98538,101667,104573,-2.78
2024-06-27,D012,6492,93408,99900,95035,5.12
2024-06-27,D012,5136,58172,63308,63526,-0.34
2024-07-05,D012,5041,51828,56869,57761,-1.54
2024-07-11,D012,3021,70953,73974,73783,0.26
2024-07-17,D012,5190,59108,64298,63312,1.56
2024-07-20,D012,5577,86748,92325,88065,4.84
2024-07-23,D012,6948,58169,65117,67567,-3.63
2024-07-26,D012,5417,98003,103420,102415,0.98
2024-07-28,D012,3528,87661,91189,93846,-2.83
2024-07-31,D012,3551,92770,96321,94903,1.49
2024-08-03,D012,4604,64419,69023,68337,1
2024-08-08,D012,4451,53823,58274,56012,4.04
2024-08-16,D012,6702,85255,91957,90172,1.98
2024-08-20,D012,5990,84964,90954,90486,0.52
2024-08-24,D012,6021,63304,69325,67277,3.04
2024-08-25,D012,5057,83431,88488,86820,1.92
2024-08-25,D012,4405,56895,61300,63141,-2.92
2024-08-28,D012,5060,77794,82854,83891,-1.24
2024-08-30,D012,4643,63647,68290,65749,3.86
2024-09-04,D012,5349,69157,74506,75244,-0.98
2024-09-07,D012,6879,69266,76145,73896,3.04
2024-09-11,D012,6156,61721,67877,69322,-2.08
2024-09-13,D012,5580,96612,102192,105141,-2.8
2024-09-14,D012,5533,63828,69361,67820,2.27
2024-09-18,D012,3729,54378,58107,53292,9.04
2024-09-23,D012,5315,86009,91324,91267,0.06
2024-09-23,D012,6585,94721,101306,97969,3.41
2024-09-27,D012,6410,79659,86069,81478,5.63
2024-09-30,D012,4294,73019,77313,78058,-0.95
2024-10-06,D012,3545,96900,100445,98333,2.15
2024-10-08,D012,6577,69644,76221,75674,0.72
2024-10-13,D012,5519,92358,97877,94080,4.04
2024-10-14,D012,3127,61871,64998,63811,1.86
2024-10-21,D012,6457,73938,80395,76115,5.62
2024-10-27,D012,6775,89143,95918,91820,4.46
2024-10-28,D012,6958,89951,96909,94661,2.37
2024-11-06,D012,4492,68231,72723,68872,5.59
2024-11-11,D012,4856,73924,78780,78628,0.19
2024-11-13,D012,5483,68242,73725,71944,2.48
2024-11-14,D012,6916,76624,83540,85082,-1.81
2024-11-20,D012,6137,53898,60035,62200,-3.48
2024-11-21,D012,6323,92305,98628,99205,-0.58
2024-11-29,D012,5833,70890,76723,77392,-0.86
2024-12-06,D012,5306,82852,88158,85517,3.09
2024-12-10,D012,6655,73274,79929,77998,2.48
2024-12-11,D012,3200,75097,78297,79410,-1.4
2024-12-11,D012,3790,95713,99503,95018,4.72
2024-12-16,D012,3415,51909,55324,57409,-3.63
2024-12-27,D012,3298,69622,72920,70088,4.04
2024-01-03,D013,3769,50015,53784,56179,-4.26
2024-01-07,D013,6226,65881,72107,72514,-0.56
2024-01-18,D013,5741,56256,61997,64769,-4.28
2024-01-18,D013,6897,65861,72758,74163,-1.89
2024-01-25,D013,3739,79784,83523,80800,3.37
2024-01-31,D013,3845,78179,82024,79247,3.5
2024-01-31,D013,4921,75958,80879,81305,-0.52
2024-02-06,D013,3797,63740,67537,64933,4.01
2024-02-08,D013,4558,72257,76815,76378,0.57
2024-02-08,D013,6547,69257,75804,75458,0.46
2024-02-09,D013,3181,98336,101517,103615,-2.02
2024-02-12,D013,3906,77567,81473,83563,-2.5
2024-02-19,D013,4546,63979,68525,67962,0.83
2024-02-23,D013,6892,95104,101996,104535,-2.43
2024-02-25,D013,6598,97800,104398,99405,5.02
2024-02-28,D013,6035,76016,82051,78551,4.46
2024-03-05,D013,4299,63112,67411,64029,5.28
2024-03-09,D013,4868,63056,67924,63668,6.68
2024-03-16,D013,4778,98897,103675,99091,4.63
2024-03-17,D013,5163,93201,98364,94031,4.61
2024-03-18,D013,4636,65797,70433,71978,-2.15
2024-03-19,D013,4147,89382,93529,95288,-1.85
2024-03-20,D013,6527,98426,104953,104938,0.01
2024-03-23,D013,5224,91157,96381,96710,-0.34
2024-03-24,D013,6765,65950,72715,71405,1.83
2024-03-27,D013,5763,54314,60077,58983,1.85
2024-03-31,D013,3199,77209,80408,81617,-1.48
2024-03-31,D013,6003,67580,73583,75371,-2.37
2024-04-02,D013,3625,78955,82580,83601,-1.22
2024-04-07,D013,5152,90034,95186,97676,-2.55
2024-04-07,D013,4143,99444,103587,104748,-1.11
2024-04-12,D013,5665,67772,73437,74022,-0.79
2024-04-25,D013,3956,93074,97030,94386,2.8
2024-04-25,D013,4436,58728,63164,65213,-3.14
2024-04-27,D013,4508,86854,91362,87618,4.27
2024-04-29,D013,3892,60222,64114,63954,0.25
2024-04-30,D013,3345,95779,99124,99176,-0.05
2024-05-04,D013,5163,84477,89640,84780,5.73
2024-05-05,D013,4786,66259,71045,68330,3.97
2024-05-06,D013,5752,99394,105146,106262,-1.05
2024-05-10,D013,4475,51499,55974,51544,8.59
2024-05-17,D013,4489,54383,58872,57936,1.62
2024-05-17,D013,6920,55693,62613,61731,1.43
2024-05-18,D013,5611,64322,69933,67285,3.94
2024-05-20,D013,4297,98543,102840,100113,2.72
2024-05-25,D013,4878,69680,74558,75618,-1.4
2024-05-25,D013,3477,58906,62383,63707,-2.08
2024-05-30,D013,5493,57910,63403,58748,7.92
2024-06-01,D013,6174,74265,80439,82648,-2.67
2024-06-01,D013,3999,81495,85494,82277,3.91
2024-06-07,D013,3488,89882,93370,95023,-1.74
2024-06-07,D013,6654,73486,80140,80781,-0.79
2024-06-10,D013,3364,71300,74664,72166,3.46
2024-06-11,D013,4578,54023,58601,53811,8.9
2024-06-12,D013,3375,62940,66315,65976,0.51
2024-06-15,D013,3299,72555,75854,75359,0.66
2024-06-16,D013,5217,77569,82786,78848,4.99
2024-06-17,D013,6535,80522,87057,84101,3.51
2024-06-17,D013,4716,81085,85801,83504,2.75
2024-06-18,D013,4020,57093,61113,59149,3.32
2024-06-19,D013,4948,71170,76118,76901,-1.02
2024-06-19,D013,5004,97764,102768,104121,-1.3
2024-06-21,D013,5015,71793,76808,77716,-1.17
2024-06-27,D013,3843,99725,103568,102354,1.19
2024-06-28,D013,3065,63107,66172,63705,3.87
2024-07-01,D013,6728,57432,64160,60929,5.3
2024-07-06,D013,6512,96165,102677,104178,-1.44
2024-07-07,D013,3997,93056,97053,98728,-1.7
2024-07-17,D013,4759,70742,75501,77052,-2.01
2024-07-22,D013,4506,77793,82299,80543,2.18
2024-07-24,D013,3502,92299,95801,94916,0.93
2024-07-25,D013,5733,86535,92268,89884,2.65
2024-07-26,D013,6863,94748,101611,101900,-0.28
2024-07-26,D013,6955,57933,64888,66644,-2.63
2024-08-01,D013,6803,70765,77568,76741,1.08
2024-08-02,D013,5482,74442,79924,81973,-2.5
2024-08-08,D013,3772,67913,71685,73604,-2.61
2024-08-10,D013,3883,57334,61217,57790,5.93
2024-08-13,D013,6224,74262,80486,76779,4.83
2024-08-13,D013,4074,51209,55283,53130,4.05
2024-08-16,D013,4520,91115,95635,93043,2.79
2024-08-17,D013,4937,82001,86938,82507,5.37
2024-08-18,D013,4323,85490,89813,90455,-0.71
2024-08-19,D013,4896,77114,82010,81320,0.85
2024-08-23,D013,6348,93560,99908,100228,-0.32
2024-08-29,D013,4243,53709,57952,59871,-3.21
2024-09-02,D013,5689,98601,104290,102368,1.88
2024-09-10,D013,6006,78570,84576,81501,3.77
2024-09-10,D013,3920,83537,87457,89114,-1.86
2024-09-11,D013,4973,97114,102087,100043,2.04
2024-09-12,D013,5354,62213,67567,67352,0.32
2024-09-22,D013,3909,62497,66406,64748,2.56
2024-09-23,D013,3053,66999,70052,67874,3.21
2024-09-24,D013,3838,88912,92750,94054,-1.39
2024-09-27,D013,6672,57382,64054,60467,5.93
2024-09-28,D013,5773,90403,96176,92764,3.68
2024-10-05,D013,5264,52914,58178,56210,3.5
2024-10-07,D013,4387,54274,58661,59376,-1.2
2024-10-12,D013,4921,71330,76251,79141,-3.65
2024-10-15,D013,4924,79401,84325,86737,-2.78
2024-10-19,D013,6664,65764,72428,72441,-0.02
2024-10-24,D013,5696,96686,102382,103200,-0.79
2024-10-24,D013,3371,77383,80754,76734,5.24
2024-10-25,D013,4099,75362,79461,82313,-3.46
2024-10-29,D013,3086,83205,86291,86703,-0.48
2024-11-01,D013,4147,54114,58261,55885,4.25
2024-11-02,D013,6903,57219,64122,61794,3.77
2024-11-03,D013,6641,53359,60000,57928,3.58
2024-11-07,D013,4135,65196,69331,69475,-0.21
2024-11-19,D013,3813,50845,54658,56494,-3.25
2024-11-23,D013,5743,76372,82115,80752,1.69
2024-11-29,D013,5160,80552,85712,81768,4.82
2024-12-20,D013,3946,76911,80857,82375,-1.84
2024-12-21,D013,5525,66508,72033,70401,2.32
2024-12-26,D013,6270,54427,60697,58413,3.91
2024-12-26,D013,6937,83751,90688,88081,2.96
2024-01-02,D014,3374,76916,80290,76310,5.22
2024-01-04,D014,5091,97671,102762,98041,4.82
2024-01-09,D014,5599,86801,92400,95164,-2.9
2024-01-11,D014,3582,96807,100389,98756,1.65
2024-01-12,D014,4179,66043,70222,68650,2.29
2024-01-13,D014,5950,64719,70669,69018,2.39
2024-01-13,D014,6511,91851,98362,98375,-0.01
2024-01-16,D014,3326,85474,88800,91799,-3.27
2024-01-26,D014,3938,54899,58837,57831,1.74
2024-01-28,D014,5125,94247,99372,94819,4.8
2024-02-13,D014,3143,94896,98039,96611,1.48
2024-02-13,D014,6162,92811,98973,98432,0.55
2024-02-15,D014,6746,61548,68294,64371,6.09
2024-02-18,D014,3100,72259,75359,74088,1.72
2024-02-19,D014,4945,80279,85224,82012,3.92
2024-02-21,D014,5541,86378,91919,93227,-1.4
2024-02-22,D014,5801,54581,60382,59667,1.2
2024-02-25,D014,4253,89963,94216,95361,-1.2
2024-03-02,D014,3131,66984,70115,67247,4.26
2024-03-03,D014,3508,60531,64039,63877,0.25
2024-03-05,D014,6413,90225,96638,97023,-0.4
2024-03-05,D014,3613,64274,67887,70019,-3.04
2024-03-09,D014,5165,50887,56052,51826,8.15
2024-03-11,D014,5773,78082,83855,81159,3.32
2024-03-13,D014,3101,92589,95690,92990,2.9
2024-03-15,D014,4065,91381,95446,95563,-0.12
2024-03-18,D014,6243,66672,72915,70251,3.79
2024-03-21,D014,3273,58050,61323,60294,1.71
2024-03-24,D014,6214,85167,91381,89741,1.83
2024-03-25,D014,4053,90660,94713,93569,1.22
2024-03-30,D014,3687,97124,100811,99150,1.68
2024-04-02,D014,5835,57860,63695,59169,7.65
2024-04-04,D014,3309,72523,75832,77258,-1.85
2024-04-09,D014,4673,90854,95527,94845,0.72
2024-04-14,D014,6389,96882,103271,100902,2.35
2024-04-14,D014,5216,62504,67720,70343,-3.73
2024-04-17,D014,5840,65762,71602,71492,0.15
2024-04-20,D014,6051,83194,89245,85099,4.87
2024-04-23,D014,5497,79473,84970,83904,1.27
2024-04-27,D014,4737,59096,63833,63279,0.88
2024-04-29,D014,6965,88454,95419,97369,-2
2024-05-02,D014,3594,88046,91640,89027,2.94
2024-05-03,D014,6032,61889,67921,68084,-0.24
2024-05-06,D014,5895,96435,102330,100795,1.52
2024-05-07,D014,4454,62612,67066,65529,2.35
2024-05-09,D014,3968,97614,101582,103266,-1.63
2024-05-11,D014,4877,77378,82255,82769,-0.62
2024-05-11,D014,5838,59065,64903,67820,-4.3
2024-05-27,D014,3600,68409,72009,73425,-1.93
2024-05-28,D014,5670,78688,84358,80301,5.05
2024-06-02,D014,4244,52416,56660,52559,7.8
2024-06-06,D014,3976,92399,96375,96322,0.06
2024-06-06,D014,3065,56092,59157,59251,-0.16
2024-06-09,D014,5118,50663,55781,53717,3.84
2024-06-12,D014,4443,96926,101369,102826,-1.42
2024-06-20,D014,5133,75433,80566,78261,2.95
2024-06-24,D014,5172,97501,102673,99399,3.29
2024-06-28,D014,5424,94835,100259,100436,-0.18
2024-07-05,D014,5292,84269,89561,88157,1.59
2024-07-13,D014,4420,86145,90565,86064,5.23
2024-07-17,D014,3390,72152,75542,75724,-0.24
2024-07-20,D014,5254,50414,55668,56400,-1.3
2024-07-21,D014,3287,78554,81841,78509,4.24
2024-07-21,D014,4052,83481,87533,83273,5.12
2024-07-23,D014,6048,79402,85450,84098,1.61
2024-07-24,D014,4222,96998,101220,100978,0.24
2024-07-24,D014,5840,64051,69891,69944,-0.08
2024-08-02,D014,6474,74703,81177,78236,3.76
2024-08-02,D014,4275,51016,55291,50422,9.66
2024-08-04,D014,3910,63313,67223,68664,-2.1
2024-08-07,D014,5327,82391,87718,90101,-2.64
2024-08-08,D014,6223,89534,95757,93455,2.46
2024-08-14,D014,4259,59083,63342,60768,4.24
2024-08-16,D014,5044,60837,65881,65165,1.1
2024-08-19,D014,6332,99855,106187,102119,3.98
2024-08-19,D014,6491,53513,60004,62509,-4.01
2024-08-24,D014,5332,83097,88429,89332,-1.01
2024-08-26,D014,5045,53907,58952,61145,-3.59
2024-08-29,D014,5041,61016,66057,61544,7.33
2024-09-07,D014,3878,65935,69813,65347,6.83
2024-09-12,D014,5840,65663,71503,67527,5.89
2024-09-13,D014,4232,78952,83184,81646,1.88
2024-09-14,D014,6695,50716,57411,54753,4.85
2024-09-16,D014,4264,70108,74372,74585,-0.29
2024-09-16,D014,3413,84782,88195,89814,-1.8
2024-09-22,D014,6723,50363,57086,57920,-1.44
2024-09-23,D014,6740,83953,90693,90408,0.32
2024-10-01,D014,3205,57207,60412,60068,0.57
2024-10-02,D014,3891,58204,62095,59973,3.54
2024-10-03,D014,3815,53987,57802,59275,-2.49
2024-10-05,D014,5429,93020,98449,97051,1.44
2024-10-10,D014,4153,97992,102145,103055,-0.88
2024-10-13,D014,4585,63500,68085,67717,0.54
2024-10-16,D014,3047,85132,88179,88923,-0.84
2024-10-18,D014,4745,97598,102343,101911,0.42
2024-10-20,D014,3551,71950,75501,75604,-0.14
2024-10-23,D014,5385,59522,64907,60312,7.62
2024-10-25,D014,5713,86953,92666,94309,-1.74
2024-11-05,D014,3558,89181,92739,87749,5.69
2024-11-10,D014,3594,63105,66699,64968,2.66
2024-11-15,D014,6055,88598,94653,90130,5.02
2024-11-15,D014,3039,64394,67433,63339,6.46
2024-11-15,D014,4573,51828,56401,57484,-1.88
2024-11-17,D014,3806,86080,89886,87749,2.44
2024-11-17,D014,4717,95516,100233,96383,3.99
2024-11-20,D014,6217,71560,77777,80055,-2.85
2024-12-01,D014,4381,75721,80102,79587,0.65
2024-12-07,D014,4821,64847,69668,66353,5
2024-12-07,D014,3116,88553,91669,88162,3.98
2024-12-08,D014,3161,52747,55908,51637,8.27
2024-12-12,D014,5293,84813,90106,92069,-2.13
2024-12-22,D014,6144,81559,87703,87465,0.27
2024-12-24,D014,5842,50206,56048,53914,3.96
2024-01-05,D015,6530,61593,68123,63136,7.9
2024-01-13,D015,3629,57407,61036,63262,-3.52
2024-01-14,D015,5345,57147,62492,57861,8
2024-01-16,D015,4537,77293,81830,77633,5.41
2024-01-19,D015,3574,74042,77616,73722,5.28
2024-01-20,D015,4983,95276,100259,102625,-2.31
2024-01-22,D015,4053,68691,72744,74516,-2.38
2024-01-26,D015,3565,94713,98278,100884,-2.58
2024-02-02,D015,3061,78900,81961,79027,3.71
2024-02-03,D015,6653,99648,106301,108797,-2.29
2024-02-04,D015,6589,55515,62104,62434,-0.53
2024-02-05,D015,4523,90821,95344,97357,-2.07
2024-02-06,D015,4721,74829,79550,80174,-0.78
2024-02-06,D015,3140,92727,95867,94124,1.85
2024-02-07,D015,5375,71754,77129,76157,1.28
2024-02-10,D015,4793,87822,92615,91747,0.95
2024-02-12,D015,3864,84036,87900,83446,5.34
2024-02-17,D015,6480,76531,83011,80756,2.79
2024-02-18,D015,3543,86668,90211,89458,0.84
2024-02-18,D015,4827,82125,86952,82973,4.8
2024-02-19,D015,6046,94518,100564,99053,1.53
2024-02-26,D015,3768,96235,100003,101355,-1.33
2024-03-04,D015,4472,56255,60727,63489,-4.35
2024-03-07,D015,4558,64012,68570,69449,-1.27
2024-03-07,D015,4878,85228,90106,92561,-2.65
2024-03-10,D015,5863,85854,91717,92947,-1.32
2024-03-18,D015,5706,54477,60183,58305,3.22
2024-03-21,D015,5804,83637,89441,86915,2.91
2024-03-24,D015,6970,76616,83586,80659,3.63
2024-03-26,D015,3762,91349,95111,92812,2.48
2024-04-01,D015,6425,63121,69546,66627,4.38
2024-04-01,D015,6601,74417,81018,83956,-3.5
2024-04-08,D015,4265,95213,99478,95725,3.92
2024-04-12,D015,3283,91476,94759,95094,-0.35
2024-04-16,D015,6217,80820,87037,85062,2.32
2024-04-19,D015,4036,67290,71326,68827,3.63
2024-04-23,D015,3896,84314,88210,88084,0.14
2024-04-26,D015,3279,74281,77560,73218,5.93
2024-04-26,D015,6590,54232,60822,60892,-0.11
2024-05-04,D015,4696,84902,89598,88706,1.01
2024-05-07,D015,4218,67601,71819,72588,-1.06
2024-05-08,D015,3822,85842,89664,87595,2.36
2024-05-11,D015,3929,69396,73325,71301,2.84
2024-05-20,D015,3582,95192,98774,100771,-1.98
2024-05-22,D015,5747,75439,81186,78214,3.8
2024-05-29,D015,6944,96390,103334,101242,2.07
2024-06-01,D015,5781,61536,67317,66352,1.45
2024-06-11,D015,5625,70609,76234,76256,-0.03
2024-06-13,D015,6154,54090,60244,58938,2.22
2024-06-14,D015,5446,58412,63858,63192,1.05
2024-06-15,D015,4248,51600,55848,53148,5.08
2024-06-17,D015,5857,89091,94948,92201,2.98
2024-06-22,D015,5548,73804,79352,77872,1.9
2024-06-25,D015,6369,58598,64967,64588,0.59
2024-06-26,D015,4990,87450,92440,89193,3.64
2024-07-04,D015,3173,62211,65384,66743,-2.04
2024-07-10,D015,4410,62665,67075,63351,5.88
2024-07-11,D015,5709,71605,77314,75909,1.85
2024-07-12,D015,6014,55166,61180,57059,7.22
2024-07-15,D015,3898,94324,98222,94786,3.63
2024-07-23,D015,6967,68975,75942,77469,-1.97
2024-07-30,D015,4543,77915,82458,82750,-0.35
2024-08-07,D015,5163,61064,66227,66107,0.18
2024-08-07,D015,4526,90677,95203,96234,-1.07
2024-08-11,D015,3517,74811,78328,77830,0.64
2024-08-13,D015,6031,85680,91711,87439,4.89
2024-08-15,D015,5679,92007,97686,96052,1.7
2024-08-18,D015,6688,53748,60436,57094,5.85
2024-08-19,D015,6815,91201,98016,96219,1.87
2024-08-21,D015,5071,85865,90936,92532,-1.72
2024-08-21,D015,5622,92691,98313,101287,-2.94
2024-08-22,D015,4354,67950,72304,72909,-0.83
2024-08-23,D015,5381,75464,80845,76329,5.92
2024-08-24,D015,6097,59336,65433,61784,5.91
2024-08-29,D015,5675,85948,91623,90307,1.46
2024-08-31,D015,4684,81889,86573,87048,-0.55
2024-09-04,D015,4195,51753,55948,57276,-2.32
2024-09-09,D015,5828,85618,91446,89339,2.36
2024-09-11,D015,6424,75976,82400,79628,3.48
2024-09-15,D015,3810,61586,65396,67317,-2.85
2024-09-19,D015,4529,92768,97297,93642,3.9
2024-09-22,D015,6732,73798,80530,78157,3.04
2024-09-23,D015,5713,96121,101834,100328,1.5
2024-09-24,D015,4319,51141,55460,53833,3.02
2024-09-24,D015,5173,75992,81165,79308,2.34
2024-09-25,D015,4019,94225,98244,99841,-1.6
2024-09-25,D015,6483,60912,67395,64657,4.23
2024-09-27,D015,5808,86833,92641,89743,3.23
2024-10-01,D015,4301,93319,97620,92924,5.05
2024-10-14,D015,5299,77912,83211,79797,4.28
2024-10-15,D015,4176,74340,78516,81116,-3.21
2024-10-16,D015,5467,74914,80381,80557,-0.22
2024-10-18,D015,3573,80848,84421,82315,2.56
2024-10-26,D015,4645,60435,65080,63568,2.38
2024-10-27,D015,4222,70967,75189,70916,6.03
2024-10-29,D015,3638,50055,53693,51872,3.51
2024-10-30,D015,6743,80924,87667,88663,-1.12
2024-11-02,D015,4797,94122,98919,100187,-1.27
2024-11-11,D015,3350,97657,101007,101983,-0.96
2024-11-14,D015,6041,65791,71832,71357,0.67
2024-11-23,D015,5258,90927,96185,97112,-0.95
2024-11-28,D015,6148,69743,75891,77887,-2.56
2024-11-28,D015,6433,70653,77086,72317,6.59
2024-12-01,D015,5640,68945,74585,74336,0.33
2024-12-01,D015,6610,71577,78187,79973,-2.23
2024-12-01,D015,5186,66630,71816,71597,0.31
2024-12-02,D015,4503,68653,73156,70881,3.21
2024-12-04,D015,3071,82161,85232,84263,1.15
2024-12-09,D015,3148,95638,98786,101666,-2.83
2024-12-11,D015,5098,82471,87569,84250,3.94
2024-12-11,D015,5990,51195,57185,55626,2.8
2024-12-19,D015,4257,94350,98607,94421,4.43
2024-12-20,D015,6205,58669,64874,61098,6.18
2024-12-22,D015,5574,70209,75783,74190,2.15
2024-12-27,D015,3759,51798,55557,53398,4.04
2024-01-02,D016,5805,83489,89294,84616,5.53
2024-01-03,D016,3214,94938,98152,100017,-1.86
2024-01-07,D016,3947,90461,94408,97336,-3.01
2024-01-12,D016,3656,96479,100135,101204,-1.06
2024-01-12,D016,5850,78400,84250,85182,-1.09
2024-01-12,D016,4353,60975,65328,65497,-0.26
2024-01-20,D016,6647,71792,78439,79823,-1.73
2024-01-20,D016,6916,69755,76671,77198,-0.68
2024-01-22,D016,3996,51607,55603,52668,5.57
2024-01-22,D016,3212,74885,78097,78389,-0.37
2024-01-25,D016,6893,89579,96472,98376,-1.94
2024-02-10,D016,5079,62861,67940,70274,-3.32
2024-02-11,D016,3464,55741,59205,61928,-4.4
2024-02-12,D016,6539,60558,67097,62438,7.46
2024-02-15,D016,4813,94223,99036,100493,-1.45
2024-02-19,D016,5930,99151,105081,105878,-0.75
2024-02-21,D016,6726,85757,92483,88421,4.59
2024-02-28,D016,5000,80962,85962,82893,3.7
2024-03-02,D016,5928,59885,65813,66498,-1.03
2024-03-03,D016,6838,90843,97681,99105,-1.44
2024-03-07,D016,4516,68161,72677,70615,2.92
2024-03-13,D016,5014,69856,74870,74228,0.86
2024-03-14,D016,3010,98926,101936,101097,0.83
2024-03-17,D016,5515,72706,78221,78529,-0.39
2024-03-20,D016,5181,52260,57441,57494,-0.09
2024-03-23,D016,6498,59140,65638,61840,6.14
2024-03-26,D016,3319,96111,99430,102095,-2.61
2024-04-02,D016,4801,61083,65884,63927,3.06
2024-04-03,D016,3737,59280,63017,61834,1.91
2024-04-04,D016,4883,52886,57769,60292,-4.18
2024-04-05,D016,6068,56855,62923,63629,-1.11
2024-04-15,D016,5493,73197,78690,81058,-2.92
2024-04-24,D016,5754,74918,80672,80943,-0.33
2024-05-01,D016,4253,92042,96295,97152,-0.88
2024-05-04,D016,6817,72076,78893,79539,-0.81
2024-05-05,D016,6373,77597,83970,83778,0.23
2024-05-06,D016,3884,53051,56935,54613,4.25
2024-05-14,D016,4867,68953,73820,74192,-0.5
2024-05-20,D016,5521,71534,77055,79172,-2.67
2024-05-31,D016,4515,64179,68694,71655,-4.13
2024-06-01,D016,6175,88015,94190,95456,-1.33
2024-06-12,D016,3480,76707,80187,82087,-2.31
2024-06-13,D016,3181,71389,74570,70692,5.49
2024-06-16,D016,5139,97456,102595,98881,3.76
2024-06-17,D016,3160,88467,91627,87683,4.5
2024-06-21,D016,6574,86087,92661,94255,-1.69
2024-06-27,D016,5550,79466,85016,86430,-1.64
2024-07-04,D016,4078,56643,60721,60774,-0.09
2024-07-06,D016,6695,60691,67386,63830,5.57
2024-07-06,D016,3670,87960,91630,88008,4.12
2024-07-07,D016,3703,59662,63365,65785,-3.68
2024-07-08,D016,5931,99570,105501,104720,0.75
2024-07-10,D016,5367,70157,75524,75897,-0.49
2024-07-17,D016,4574,98784,103358,100682,2.66
2024-07-17,D016,3400,62182,65582,62669,4.65
2024-07-18,D016,6228,54582,60810,58855,3.32
2024-07-22,D016,5241,61944,67185,66450,1.11
2024-07-31,D016,5881,98015,103896,104556,-0.63
2024-08-02,D016,6754,93262,100016,97510,2.57
2024-08-05,D016,5521,85247,90768,87284,3.99
2024-08-07,D016,4935,63699,68634,67110,2.27
2024-08-08,D016,6080,84592,90672,91181,-0.56
2024-08-13,D016,3220,96994,100214,97176,3.13
2024-08-18,D016,4262,87116,91378,92374,-1.08
2024-08-23,D016,5919,51462,57381,54860,4.6
2024-08-24,D016,6605,70947,77552,73655,5.29
2024-08-25,D016,6485,85315,91800,91636,0.18
2024-08-29,D016,5893,75825,81718,82190,-0.57
2024-08-31,D016,4550,89137,93687,90079,4.01
2024-09-02,D016,4199,70460,74659,70888,5.32
2024-09-02,D016,5780,74762,80542,81745,-1.47
2024-09-03,D016,4271,85658,89929,90172,-0.27
2024-09-03,D016,5305,79168,84473,86578,-2.43
2024-09-12,D016,3017,68836,71853,72007,-0.21
2024-09-13,D016,6727,96500,103227,105969,-2.59
2024-09-18,D016,3952,63675,67627,66041,2.4
2024-09-19,D016,6634,67472,74106,70698,4.82
2024-09-21,D016,4774,73814,78588,80167,-1.97
2024-09-25,D016,3369,67019,70388,68163,3.26
2024-09-27,D016,6824,83307,90131,90349,-0.24
2024-09-30,D016,3688,65185,68873,71041,-3.05
2024-10-02,D016,5346,66555,71901,70759,1.61
2024-10-05,D016,6718,78185,84903,83968,1.11
2024-10-15,D016,3962,89051,93013,94037,-1.09
2024-10-23,D016,3985,66128,70113,72747,-3.62
2024-11-01,D016,5681,85967,91648,87880,4.29
2024-11-03,D016,5588,93151,98739,99104,-0.37
2024-11-04,D016,3560,51187,54747,54614,0.24
2024-11-05,D016,4109,80811,84920,80093,6.03
2024-11-08,D016,5942,96364,102306,101996,0.3
2024-11-09,D016,6246,61443,67689,64638,4.72
2024-11-10,D016,6309,82627,88936,89219,-0.32
2024-11-13,D016,4770,68950,73720,75745,-2.67
2024-11-29,D016,6996,53225,60221,59603,1.04
2024-12-11,D016,3623,91976,95599,94956,0.68
2024-12-15,D016,5030,57082,62112,64156,-3.19
2024-12-16,D016,6981,55798,62779,64344,-2.43
2024-12-18,D016,4419,55409,59828,61350,-2.48
2024-12-22,D016,5966,98302,104268,103540,0.7
2024-12-23,D016,6259,89233,95492,93947,1.64
2024-01-08,D017,4466,97020,101486,103948,-2.37
2024-01-14,D017,4656,69873,74529,69925,6.58
2024-01-14,D017,3919,90888,94807,92894,2.06
2024-01-17,D017,5037,58848,63885,66720,-4.25
2024-01-19,D017,5778,78997,84775,86781,-2.31
2024-01-24,D017,6699,97766,104465,101496,2.93
2024-01-26,D017,6480,77724,84204,81156,3.76
2024-01-28,D017,3219,50405,53624,54987,-2.48
2024-02-05,D017,4090,97985,102075,103385,-1.27
2024-02-11,D017,6438,96971,103409,99481,3.95
2024-02-21,D017,6717,99476,106193,104106,2
2024-02-28,D017,4113,57659,61772,61502,0.44
2024-03-01,D017,6579,66506,73085,70469,3.71
2024-03-11,D017,3155,85429,88584,84404,4.95
2024-03-12,D017,6860,76589,83449,81010,3.01
2024-03-13,D017,6085,82924,89009,91275,-2.48
2024-03-14,D017,6298,54470,60768,58149,4.5
2024-03-18,D017,3428,56509,59937,55244,8.5
2024-03-27,D017,6213,68748,74961,72131,3.92
2024-03-29,D017,4197,78223,82420,80182,2.79
2024-03-29,D017,5533,85165,90698,86447,4.92
2024-03-30,D017,4987,62598,67585,70029,-3.49
2024-04-02,D017,6380,58711,65091,67501,-3.57
2024-04-06,D017,5121,96270,101391,100313,1.07
2024-04-06,D017,4811,81885,86696,84811,2.22
2024-04-07,D017,3965,62485,66450,66793,-0.51
2024-04-08,D017,6835,84919,91754,93517,-1.89
2024-04-16,D017,4481,54081,58562,55108,6.27
2024-04-18,D017,6807,89919,96726,98425,-1.73
2024-04-20,D017,6909,58015,64924,64504,0.65
2024-04-25,D017,4513,54876,59389,60938,-2.54
2024-04-25,D017,3142,79896,83038,78691,5.52
2024-04-28,D017,6453,89857,96310,95703,0.63
2024-05-07,D017,5387,79299,84686,81104,4.42
2024-05-09,D017,5712,53084,58796,56043,4.91
2024-05-17,D017,6504,85285,91789,92392,-0.65
2024-05-20,D017,4331,54539,58870,55231,6.59
2024-05-24,D017,3962,93965,97927,97121,0.83
2024-05-26,D017,3665,88635,92300,88337,4.49
2024-05-31,D017,6644,83340,89984,85463,5.29
2024-05-31,D017,6229,60892,67121,67116,0.01
2024-06-02,D017,4144,55243,59387,62238,-4.58
2024-06-04,D017,5834,75370,81204,81725,-0.64
2024-06-07,D017,3782,78792,82574,84809,-2.64
2024-06-13,D017,5925,79989,85914,87372,-1.67
2024-06-16,D017,4189,63908,68097,65021,4.73
2024-06-19,D017,6608,82130,88738,84364,5.18
2024-06-20,D017,4801,57699,62500,62871,-0.59
2024-06-26,D017,6085,91205,97290,96204,1.13
2024-06-27,D017,3223,88157,91380,90307,1.19
2024-06-27,D017,4599,80204,84803,86648,-2.13
2024-07-10,D017,3729,85029,88758,89137,-0.43
2024-07-10,D017,3761,85953,89714,92689,-3.21
2024-07-11,D017,3548,61640,65188,66327,-1.72
2024-07-11,D017,4004,75052,79056,76815,2.92
2024-07-14,D017,5374,83085,88459,84507,4.68
2024-07-19,D017,6832,98738,105570,103655,1.85
2024-07-19,D017,3928,85547,89475,85580,4.55
2024-07-20,D017,4345,94746,99091,101556,-2.43
2024-07-26,D017,4319,65398,69717,72430,-3.75
2024-07-28,D017,5163,60774,65937,61672,6.92
2024-07-28,D017,6056,67576,73632,72207,1.97
2024-08-02,D017,4508,52421,56929,52810,7.8
2024-08-11,D017,4009,60931,64940,60238,7.81
2024-08-13,D017,4702,98710,103412,105539,-2.02
2024-08-15,D017,5960,55773,61733,60139,2.65
2024-08-16,D017,6647,80554,87201,83713,4.17
2024-08-19,D017,5475,79114,84589,81559,3.72
2024-08-20,D017,4693,83204,87897,88069,-0.2
2024-08-23,D017,5732,70637,76369,75102,1.69
2024-08-23,D017,6511,82347,88858,90870,-2.21
2024-08-26,D017,6294,89542,95836,91868,4.32
2024-08-28,D017,3855,94985,98840,95253,3.77
2024-08-29,D017,4567,97878,102445,97555,5.01
2024-08-31,D017,3326,83754,87080,86962,0.14
2024-09-15,D017,3865,83368,87233,82429,5.83
2024-09-24,D017,6199,91797,97996,98034,-0.04
2024-09-27,D017,3803,87083,90886,87728,3.6
2024-09-28,D017,3142,74162,77304,74296,4.05
2024-09-30,D017,3789,50594,54383,51182,6.25
2024-10-09,D017,5990,74833,80823,83249,-2.91
2024-10-12,D017,3870,78684,82554,78803,4.76
2024-10-17,D017,5401,59686,65087,62170,4.69
2024-10-17,D017,6071,72025,78096,78169,-0.09
2024-10-18,D017,6028,75095,81123,78167,3.78
2024-11-01,D017,5075,94291,99366,94665,4.97
2024-11-03,D017,3653,65993,69646,66218,5.18
2024-11-11,D017,4520,57975,62495,62727,-0.37
2024-11-17,D017,6015,66457,72472,71626,1.18
2024-11-19,D017,4583,72963,77546,75316,2.96
2024-11-22,D017,3216,51324,54540,56385,-3.27
2024-11-25,D017,3369,68485,71854,70069,2.55
2024-11-25,D017,3865,83541,87406,85919,1.73
2024-11-26,D017,5973,92856,98829,100320,-1.49
2024-11-29,D017,5331,95530,100861,98688,2.2
2024-12-02,D017,3880,65072,68952,68017,1.37
2024-12-05,D017,6031,86932,92963,93370,-0.44
2024-12-07,D017,4828,98979,103807,106504,-2.53
2024-12-08,D017,3855,81186,85041,81317,4.58
2024-12-13,D017,4765,95180,99945,101132,-1.17
2024-12-16,D017,4451,98356,102807,104018,-1.16
2024-12-20,D017,5532,74255,79787,82744,-3.57
2024-12-30,D017,6648,55445,62093,62465,-0.6
2024-01-05,D018,3915,73165,77080,72326,6.57
2024-01-06,D018,4857,51607,56464,51690,9.24
2024-01-10,D018,4129,84470,88599,89598,-1.11
2024-01-31,D018,6819,53055,59874,56398,6.16
2024-02-04,D018,5160,68318,73478,71424,2.88
2024-02-06,D018,4817,72754,77571,76156,1.86
2024-02-07,D018,4978,89422,94400,94960,-0.59
2024-02-13,D018,6777,53841,60618,56520,7.25
2024-02-16,D018,5024,58924,63948,64202,-0.4
2024-02-19,D018,4230,73091,77321,73324,5.45
2024-02-23,D018,5799,78525,84324,83217,1.33
2024-02-25,D018,6258,85585,91843,94399,-2.71
2024-02-26,D018,5744,87834,93578,88845,5.33
2024-03-03,D018,4656,62278,66934,69709,-3.98
2024-03-04,D018,4913,66289,71202,67492,5.5
2024-03-06,D018,5038,82113,87151,85881,1.48
2024-03-07,D018,3009,86912,89921,87315,2.98
2024-03-10,D018,4361,83359,87720,90194,-2.74
2024-03-13,D018,3928,51951,55879,51011,9.54
2024-03-16,D018,3438,78379,81817,78838,3.78
2024-03-17,D018,4594,56372,60966,62340,-2.2
2024-03-18,D018,6639,52105,58744,60191,-2.4
2024-03-18,D018,5700,55063,60763,60130,1.05
2024-03-18,D018,5761,93309,99070,100138,-1.07
2024-03-20,D018,3129,95331,98460,98501,-0.04
2024-03-20,D018,6763,77407,84170,81974,2.68
2024-03-24,D018,4053,66960,71013,70918,0.13
2024-03-27,D018,4025,52251,56276,54519,3.22
2024-03-31,D018,6925,58463,65388,67360,-2.93
2024-04-01,D018,4970,72190,77160,74018,4.24
2024-04-03,D018,3661,63045,66706,65322,2.12
2024-04-04,D018,6837,88244,95081,92420,2.88
2024-04-05,D018,4687,73190,77877,73520,5.93
2024-04-08,D018,3915,53598,57513,58141,-1.08
2024-04-12,D018,4296,74077,78373,80191,-2.27
2024-04-15,D018,4294,88862,93156,89182,4.46
2024-04-16,D018,4134,73828,77962,79725,-2.21
2024-04-16,D018,4894,52669,57563,60288,-4.52
2024-04-17,D018,4210,61226,65436,68208,-4.06
2024-04-19,D018,6837,56727,63564,62600,1.54
2024-04-20,D018,6841,86444,93285,93713,-0.46
2024-04-24,D018,6808,71125,77933,73515,6.01
2024-04-24,D018,4963,53307,58270,59909,-2.74
2024-04-29,D018,5112,74346,79458,76948,3.26
2024-05-02,D018,4728,75022,79750,80092,-0.43
2024-05-18,D018,4621,62282,66903,63204,5.85
2024-05-28,D018,3738,52773,56511,54544,3.61
2024-05-28,D018,4607,61755,66362,62207,6.68
2024-05-30,D018,4619,71637,76256,73828,3.29
2024-06-02,D018,5700,86665,92365,91124,1.36
2024-06-03,D018,4590,89605,94195,91354,3.11
2024-06-03,D018,6982,73035,80017,80607,-0.73
2024-06-08,D018,6831,98330,105161,106990,-1.71
2024-06-12,D018,6040,92422,98462,95077,3.56
2024-06-17,D018,3709,68330,72039,68924,4.52
2024-06-17,D018,3913,84881,88794,90750,-2.16
2024-06-19,D018,6851,82977,89828,87845,2.26
2024-06-19,D018,6138,76224,82362,78919,4.36
2024-06-21,D018,3115,54956,58071,59068,-1.69
2024-06-29,D018,6202,97553,103755,100643,3.09
2024-06-29,D018,5546,69775,75321,74143,1.59
2024-06-30,D018,4376,86230,90606,86324,4.96
2024-06-30,D018,3498,52809,56307,54346,3.61
2024-07-15,D018,3018,99793,102811,102728,0.08
2024-07-24,D018,4811,98895,103706,102345,1.33
2024-07-25,D018,4169,71655,75824,77010,-1.54
2024-07-27,D018,5256,73996,79252,78210,1.33
2024-08-05,D018,4579,50161,54740,53443,2.43
2024-08-06,D018,4141,91552,95693,91574,4.5
2024-08-07,D018,5205,59219,64424,61114,5.42
2024-08-18,D018,3799,61023,64822,65315,-0.75
2024-08-19,D018,6298,64056,70354,69550,1.16
2024-08-24,D018,4891,99982,104873,107825,-2.74
2024-08-28,D018,4907,57036,61943,58456,5.97
2024-09-02,D018,5810,74518,80328,82224,-2.31
2024-09-09,D018,6927,56849,63776,63529,0.39
2024-09-11,D018,5651,60006,65657,66916,-1.88
2024-09-13,D018,5637,88258,93895,89553,4.85
2024-09-13,D018,3653,58129,61782,62940,-1.84
2024-09-14,D018,5763,78469,84232,83387,1.01
2024-09-25,D018,3644,94593,98237,94559,3.89
2024-10-01,D018,4094,78562,82656,77761,6.29
2024-10-07,D018,4758,73093,77851,80282,-3.03
2024-10-20,D018,3194,67046,70240,72761,-3.46
2024-10-22,D018,5136,72555,77691,80454,-3.43
2024-10-27,D018,4699,81017,85716,88484,-3.13
2024-10-27,D018,3377,73490,76867,72548,5.95
2024-10-29,D018,3927,70893,74820,71769,4.25
2024-11-01,D018,6341,87567,93908,96222,-2.4
2024-11-02,D018,5031,60273,65304,67553,-3.33
2024-11-06,D018,3261,67826,71087,73682,-3.52
2024-11-07,D018,6478,85424,91902,93781,-2
2024-11-14,D018,5761,79240,85001,86586,-1.83
2024-11-19,D018,5686,90392,96078,98944,-2.9
2024-11-22,D018,5801,82345,88146,85443,3.16
2024-11-23,D018,6195,90928,97123,100011,-2.89
2024-11-26,D018,3426,95541,98967,100136,-1.17
2024-11-28,D018,4743,64536,69279,71833,-3.56
2024-11-28,D018,4266,73827,78093,79620,-1.92
2024-11-29,D018,5190,91908,97098,93911,3.39
2024-12-04,D018,3042,84675,87717,87227,0.56
2024-12-05,D018,3411,84764,88175,83747,5.29
2024-12-10,D018,4442,71699,76141,77016,-1.14
2024-12-28,D018,6995,59131,66126,63348,4.39
2024-12-31,D018,6566,91125,97691,99124,-1.45
2024-01-02,D019,6243,95028,101271,97168,4.22
2024-01-07,D019,6740,92998,99738,101032,-1.28
2024-01-20,D019,5262,62775,68037,63488,7.17
2024-01-23,D019,5460,79725,85185,82259,3.56
2024-01-25,D019,3527,57349,60876,58258,4.49
2024-01-25,D019,4592,51055,55647,56793,-2.02
2024-01-27,D019,6800,78133,84933,85514,-0.68
2024-01-28,D019,4095,88669,92764,95741,-3.11
2024-02-08,D019,6197,94482,100679,99411,1.28
2024-02-11,D019,4296,78350,82646,83426,-0.93
2024-02-14,D019,6473,77043,83516,85649,-2.49
2024-02-14,D019,6168,55398,61566,57888,6.35
2024-02-17,D019,3920,71304,75224,75806,-0.77
2024-02-17,D019,4109,96228,100337,99566,0.77
2024-02-24,D019,3749,54780,58529,59602,-1.8
2024-03-04,D019,4403,99483,103886,99401,4.51
2024-03-06,D019,3661,57187,60848,63816,-4.65
2024-03-06,D019,5957,68996,74953,71906,4.24
2024-03-14,D019,4256,92207,96463,94374,2.21
2024-03-16,D019,6379,60965,67344,67354,-0.01
2024-03-22,D019,5444,83768,89212,84766,5.25
2024-03-24,D019,3299,59669,62968,60568,3.96
2024-04-01,D019,4081,97030,101111,102742,-1.59
2024-04-04,D019,3222,69464,72686,74610,-2.58
2024-04-05,D019,6193,86855,93048,95287,-2.35
2024-04-08,D019,3148,55448,58596,60417,-3.01
2024-04-11,D019,6034,56828,62862,65692,-4.31
2024-04-11,D019,6975,57244,64219,60847,5.54
2024-04-18,D019,3699,64534,68233,63763,7.01
2024-04-19,D019,5994,69330,75324,76875,-2.02
2024-04-27,D019,5924,59983,65907,66304,-0.6
2024-04-27,D019,6982,53453,60435,58928,2.56
2024-04-29,D019,3933,84228,88161,85213,3.46
2024-05-02,D019,3357,72031,75388,73203,2.98
2024-05-06,D019,5252,93036,98288,100844,-2.53
2024-05-07,D019,6414,53665,60079,57194,5.04
2024-05-15,D019,3386,76617,80003,75811,5.53
2024-05-15,D019,6638,53691,60329,55859,8
2024-05-19,D019,4316,95968,100284,102160,-1.84
2024-05-24,D019,6156,88765,94921,95873,-0.99
2024-05-31,D019,4283,66035,70318,66586,5.6
2024-05-31,D019,4772,60839,65611,68601,-4.36
2024-06-04,D019,5563,76098,81661,83327,-2
2024-06-06,D019,5531,90239,95770,94051,1.83
2024-06-12,D019,6514,93326,99840,96108,3.88
2024-06-13,D019,5937,66693,72630,68969,5.31
2024-06-14,D019,6450,75738,82188,78416,4.81
2024-06-14,D019,4573,65540,70113,70205,-0.13
2024-06-22,D019,5837,99080,104917,100883,4
2024-06-23,D019,4589,87763,92352,93851,-1.6
2024-06-24,D019,6029,75936,81965,82539,-0.7
2024-06-27,D019,6991,79753,86744,86600,0.17
2024-07-04,D019,5299,75954,81253,78384,3.66
2024-07-11,D019,4476,89194,93670,93263,0.44
2024-07-15,D019,6774,88108,94882,92771,2.28
2024-07-19,D019,5331,55075,60406,61186,-1.27
2024-07-22,D019,6663,54986,61649,56927,8.29
2024-07-23,D019,3252,70517,73769,69559,6.05
2024-07-28,D019,3740,71341,75081,70639,6.29
2024-07-29,D019,3503,58070,61573,61384,0.31
2024-08-01,D019,4720,99600,104320,104308,0.01
2024-08-07,D019,4965,71224,76189,77560,-1.77
2024-08-09,D019,5902,89950,95852,91818,4.39
2024-08-13,D019,6544,77742,84286,80262,5.01
2024-08-16,D019,5002,90544,95546,98180,-2.68
2024-08-21,D019,5619,84245,89864,84997,5.73
2024-09-05,D019,5575,84890,90465,87728,3.12
2024-09-14,D019,3064,57770,60834,62885,-3.26
2024-09-15,D019,5339,70622,75961,72849,4.27
2024-09-18,D019,5131,73706,78837,75129,4.94
2024-09-21,D019,6388,55651,62039,57766,7.4
2024-09-22,D019,3186,98167,101353,102508,-1.13
2024-09-24,D019,5058,61519,66577,63038,5.61
2024-09-26,D019,6198,94436,100634,99140,1.51
2024-10-03,D019,4028,71969,75997,74298,2.29
2024-10-05,D019,3520,54725,58245,57568,1.18
2024-10-12,D019,4045,88756,92801,95697,-3.03
2024-10-13,D019,6058,63828,69886,65252,7.1
2024-10-23,D019,4620,86440,91060,89923,1.26
2024-10-28,D019,4109,84188,88297,83877,5.27
2024-10-31,D019,4856,57077,61933,64083,-3.36
2024-11-02,D019,4333,98634,102967,100502,2.45
2024-11-05,D019,3408,89023,92431,87990,5.05
2024-11-13,D019,3143,70863,74006,74743,-0.99
2024-11-13,D019,5079,52717,57796,58464,-1.14
2024-11-14,D019,6768,91910,98678,93683,5.33
2024-11-19,D019,4721,67733,72454,71758,0.97
2024-11-22,D019,4438,57463,61901,63480,-2.49
2024-11-27,D019,3583,62743,66326,66322,0.01
2024-11-27,D019,6927,75028,81955,83780,-2.18
2024-12-10,D019,6729,70662,77391,78547,-1.47
2024-12-11,D019,4971,64873,69844,68020,2.68
2024-12-11,D019,3347,67661,71008,73610,-3.53
2024-12-15,D019,5664,66783,72447,71065,1.94
2024-12-18,D019,6137,51102,57239,59642,-4.03
2024-12-23,D019,4021,98205,102226,104793,-2.45
2024-12-24,D019,3667,60234,63901,66629,-4.09
2024-12-27,D019,6520,95496,102016,102876,-0.84
2024-12-29,D019,4390,59275,63665,62019,2.65
2024-12-30,D019,4354,53712,58066,59699,-2.74
2024-01-03,D020,3383,88578,91961,94620,-2.81
2024-01-09,D020,4311,91347,95658,95537,0.13
2024-01-10,D020,6100,55423,61523,59434,3.51
2024-01-16,D020,6273,52922,59195,56346,5.06
2024-01-22,D020,6530,72042,78572,77794,1
2024-01-24,D020,4239,86918,91157,91060,0.11
2024-01-28,D020,3269,74491,77760,73879,5.25
2024-01-31,D020,6232,59643,65875,66757,-1.32
2024-02-01,D020,5607,92747,98354,99108,-0.76
2024-02-03,D020,5123,97968,103091,104148,-1.01
2024-02-05,D020,3846,70901,74747,76104,-1.78
2024-02-06,D020,5248,56192,61440,61606,-0.27
2024-02-14,D020,6179,97322,103501,101963,1.51
2024-02-16,D020,6930,93827,100757,98614,2.17
2024-02-18,D020,6049,96639,102688,104188,-1.44
2024-02-18,D020,5964,98201,104165,106462,-2.16
2024-02-22,D020,3978,66940,70918,66299,6.97
2024-02-24,D020,6266,98647,104913,105442,-0.5
2024-02-27,D020,3111,77608,80719,76239,5.88
2024-03-01,D020,5172,80151,85323,81085,5.23
2024-03-01,D020,3470,52196,55666,54483,2.17
2024-03-05,D020,3332,63824,67156,64904,3.47
2024-03-06,D020,6042,99966,106008,103386,2.54
2024-03-12,D020,3569,58411,61980,63586,-2.53
2024-03-12,D020,5399,52670,58069,59897,-3.05
2024-03-15,D020,6983,84546,91529,86627,5.66
2024-03-15,D020,4913,87065,91978,92486,-0.55
2024-03-16,D020,3400,71134,74534,74429,0.14
2024-03-18,D020,4388,91997,96385,95154,1.29
2024-03-23,D020,3802,62356,66158,63910,3.52
2024-03-25,D020,6516,64626,71142,70586,0.79
2024-03-29,D020,5156,57458,62614,63459,-1.33
2024-04-05,D020,4317,67084,71401,66874,6.77
2024-04-14,D020,6491,55492,61983,59837,3.59
2024-04-18,D020,4912,52395,57307,56162,2.04
2024-04-21,D020,6807,55178,61985,59539,4.11
2024-04-21,D020,3631,66065,69696,65061,7.12
2024-04-21,D020,3374,57226,60600,58438,3.7
2024-04-22,D020,6808,66715,73523,73074,0.61
2024-04-26,D020,4629,90546,95175,94479,0.74
2024-04-27,D020,3341,81195,84536,82354,2.65
2024-05-03,D020,5048,71447,76495,75665,1.1
2024-05-04,D020,3870,66663,70533,70569,-0.05
2024-05-06,D020,6336,51735,58071,53140,9.28
2024-05-09,D020,6814,95893,102707,102491,0.21
2024-05-10,D020,4578,88968,93546,88817,5.32
2024-05-16,D020,3982,62134,66116,61920,6.78
2024-05-23,D020,5114,86784,91898,90958,1.03
2024-05-31,D020,6633,65282,71915,70212,2.43
2024-06-02,D020,3311,85191,88502,90133,-1.81
2024-06-05,D020,3178,78803,81981,83135,-1.39
2024-06-08,D020,6953,65373,72326,67981,6.39
2024-06-16,D020,6480,66891,73371,68667,6.85
2024-06-20,D020,5156,78513,83669,82617,1.27
2024-06-25,D020,5417,54642,60059,60477,-0.69
2024-06-27,D020,4357,54134,58491,60175,-2.8
2024-07-02,D020,6853,83312,90165,90084,0.09
2024-07-04,D020,6420,80549,86969,83648,3.97
2024-07-06,D020,4105,93209,97314,93251,4.36
2024-07-10,D020,3324,55074,58398,55553,5.12
2024-07-10,D020,6364,83822,90186,89785,0.45
2024-07-15,D020,5533,53869,59402,55147,7.72
2024-07-17,D020,6626,52822,59448,62357,-4.67
2024-07-20,D020,4399,68681,73080,69491,5.16
2024-07-22,D020,5241,56378,61619,61854,-0.38
2024-07-25,D020,5198,97631,102829,105665,-2.68
2024-07-27,D020,6088,93075,99163,97935,1.25
2024-07-29,D020,5799,89346,95145,93270,2.01
2024-08-09,D020,4240,59950,64190,67093,-4.33
2024-08-23,D020,5010,57333,62343,57477,8.47
2024-08-27,D020,4070,68394,72464,75066,-3.47
2024-08-29,D020,4304,57490,61794,59935,3.1
2024-09-03,D020,4863,84747,89610,90874,-1.39
2024-09-10,D020,6298,52557,58855,56263,4.61
2024-09-14,D020,5777,69934,75711,72478,4.46
2024-09-17,D020,3804,63221,67025,68746,-2.5
2024-09-17,D020,6718,57735,64453,61214,5.29
2024-09-24,D020,5433,69206,74639,72696,2.67
2024-09-27,D020,5291,79059,84350,87137,-3.2
2024-09-29,D020,6190,93590,99780,100217,-0.44
2024-10-07,D020,3423,73383,76806,75441,1.81
2024-10-07,D020,4298,71252,75550,71564,5.57
2024-10-08,D020,5844,65360,71204,67942,4.8
2024-10-08,D020,4135,52770,56905,52360,8.68
2024-10-09,D020,6847,67748,74595,70879,5.24
2024-10-10,D020,6192,85946,92138,89086,3.43
2024-10-12,D020,4981,71834,76815,78152,-1.71
2024-10-16,D020,6131,53323,59454,62009,-4.12
2024-10-16,D020,4320,72184,76504,72609,5.36
2024-10-17,D020,4668,98328,102996,98032,5.06
2024-10-19,D020,3515,75963,79478,79025,0.57
2024-10-23,D020,3726,96316,100042,95921,4.3
2024-10-26,D020,5600,55518,61118,60875,0.4
2024-10-28,D020,6073,98246,104319,104417,-0.09
2024-11-01,D020,6480,50339,56819,59667,-4.77
2024-11-03,D020,3018,83132,86150,81683,5.47
2024-11-10,D020,4092,82470,86562,87354,-0.91
2024-11-12,D020,3184,88092,91276,88793,2.8
2024-11-12,D020,3894,92344,96238,97280,-1.07
2024-11-13,D020,5908,93350,99258,98907,0.35
2024-11-16,D020,5140,96487,101627,103446,-1.76
2024-11-16,D020,6573,84593,91166,88572,2.93
2024-11-19,D020,5698,78876,84574,81050,4.35
2024-11-21,D020,3007,84844,87851,85620,2.61
2024-11-25,D020,6069,67803,73872,74705,-1.12
2024-11-27,D020,3738,83744,87482,89111,-1.83
2024-12-03,D020,5721,97540,103261,105558,-2.18
2024-12-11,D020,6406,64662,71068,71907,-1.17
2024-12-17,D020,4734,68227,72961,75473,-3.33
2024-12-18,D020,5471,71383,76854,75004,2.47
2024-12-19,D020,3034,70641,73675,68751,7.16
2024-12-30,D020,5933,91508,97441,94980,2.59
2024-01-02,D021,3277,93847,97124,98246,-1.14
2024-01-03,D021,5738,57619,63357,62610,1.19
2024-01-04,D021,6398,96489,102887,101937,0.93
2024-01-08,D021,4307,64852,69159,71503,-3.28
2024-01-18,D021,4966,64021,68987,66811,3.26
2024-01-21,D021,3299,50138,53437,56079,-4.71
2024-01-23,D021,6976,84549,91525,94187,-2.83
2024-01-24,D021,5158,67332,72490,70532,2.78
2024-01-27,D021,6896,65646,72542,74897,-3.14
2024-01-28,D021,5535,58547,64082,63478,0.95
2024-02-06,D021,3645,67862,71507,72434,-1.28
2024-02-13,D021,4906,68105,73011,72320,0.96
2024-02-15,D021,5500,94605,100105,100460,-0.35
2024-02-18,D021,6566,65173,71739,71684,0.08
2024-02-22,D021,6222,51167,57389,57773,-0.66
2024-02-22,D021,6858,73864,80722,82418,-2.06
2024-02-22,D021,5671,51694,57365,55518,3.33
2024-02-26,D021,5265,67199,72464,67612,7.18
2024-02-27,D021,4412,85507,89919,91979,-2.24
2024-02-28,D021,3565,65701,69266,65599,5.59
2024-03-05,D021,6781,88938,95719,90889,5.31
2024-03-22,D021,6652,84521,91173,87046,4.74
2024-03-23,D021,5668,51067,56735,58229,-2.57
2024-03-26,D021,3249,66774,70023,69170,1.23
2024-03-28,D021,4486,63794,68280,64433,5.97
2024-03-28,D021,5475,73659,79134,78823,0.39
2024-04-01,D021,6838,89520,96358,99353,-3.01
2024-04-08,D021,5635,60521,66156,65202,1.46
2024-04-09,D021,3615,83715,87330,84653,3.16
2024-04-18,D021,3784,98295,102079,100587,1.48
2024-04-21,D021,6156,80211,86367,86231,0.16
2024-04-24,D021,4918,50700,55618,51495,8.01
2024-05-01,D021,6141,64175,70316,66300,6.06
2024-05-02,D021,4593,56590,61183,57327,6.73
2024-05-05,D021,4927,83069,87996,83469,5.42
2024-05-12,D021,5032,85529,90561,86558,4.62
2024-05-12,D021,6574,68588,75162,74532,0.85
2024-05-13,D021,5882,99322,105204,101848,3.3
2024-05-17,D021,6945,66515,73460,73345,0.16
2024-05-20,D021,3469,87650,91119,88198,3.31
2024-05-20,D021,6336,74714,81050,81544,-0.61
2024-05-24,D021,6057,76660,82717,81289,1.76
2024-05-26,D021,6695,86220,92915,95001,-2.2
2024-05-26,D021,6672,65150,71822,69809,2.88
2024-05-28,D021,6985,62982,69967,72043,-2.88
2024-05-28,D021,4511,96104,100615,102961,-2.28
2024-05-29,D021,5677,53236,58913,54494,8.11
2024-05-31,D021,3639,60363,64002,64297,-0.46
2024-06-03,D021,5834,60866,66700,65811,1.35
2024-06-06,D021,3347,63470,66817,64833,3.06
2024-06-07,D021,5035,84735,89770,92671,-3.13
2024-06-09,D021,3459,69769,73228,72111,1.55
2024-06-11,D021,4715,93553,98268,97132,1.17
2024-06-29,D021,4789,75188,79977,81091,-1.37
2024-06-30,D021,6390,75757,82147,82129,0.02
2024-07-02,D021,6566,79345,85911,83545,2.83
2024-07-08,D021,5093,96533,101626,102925,-1.26
2024-07-11,D021,5651,67264,72915,72101,1.13
2024-07-15,D021,5282,68330,73612,72685,1.28
2024-07-16,D021,4956,56464,61420,64242,-4.39
2024-07-18,D021,4033,99289,103322,105569,-2.13
2024-07-18,D021,3370,79685,83055,84073,-1.21
2024-07-21,D021,5811,71732,77543,74748,3.74
2024-07-22,D021,5354,75010,80364,83344,-3.58
2024-07-30,D021,4135,55127,59262,55315,7.14
2024-08-12,D021,5914,69975,75889,76742,-1.11
2024-08-14,D021,4336,78276,82612,84664,-2.42
2024-08-19,D021,6897,60142,67039,69674,-3.78
2024-08-20,D021,4417,51524,55941,55175,1.39
2024-08-22,D021,6084,79796,85880,87952,-2.36
2024-08-29,D021,5502,85436,90938,87492,3.94
2024-09-01,D021,4785,78525,83310,80362,3.67
2024-09-04,D021,3069,70308,73377,70177,4.56
2024-09-04,D021,3787,52311,56098,51873,8.14
2024-09-05,D021,3832,87146,90978,86449,5.24
2024-09-06,D021,4619,69942,74561,73083,2.02
2024-09-08,D021,5933,89823,95756,92066,4.01
2024-09-11,D021,3660,63615,67275,68976,-2.47
2024-09-13,D021,6962,92364,99326,101883,-2.51
2024-09-13,D021,3398,69984,73382,76332,-3.86
2024-09-20,D021,6301,84503,90804,92219,-1.53
2024-09-22,D021,4060,74240,78300,75839,3.25
2024-09-23,D021,3421,90775,94196,95555,-1.42
2024-09-24,D021,4585,64211,68796,65919,4.36
2024-09-29,D021,6375,82191,88566,89422,-0.96
2024-09-30,D021,3020,98402,101422,100067,1.35
2024-10-07,D021,3357,66761,70118,70899,-1.1
2024-10-13,D021,3875,76909,80784,80509,0.34
2024-10-19,D021,3583,81514,85097,85875,-0.91
2024-10-20,D021,4788,77790,82578,85329,-3.22
2024-10-24,D021,4280,85807,90087,89292,0.89
2024-10-28,D021,5278,64042,69320,71398,-2.91
2024-10-28,D021,3479,60654,64133,60825,5.44
2024-10-29,D021,3868,78602,82470,81291,1.45
2024-11-05,D021,6465,52711,59176,59769,-0.99
2024-11-15,D021,4945,60731,65676,66316,-0.97
2024-11-27,D021,4782,76140,80922,82738,-2.19
2024-12-05,D021,4456,50627,55083,54286,1.47
2024-12-08,D021,5108,53947,59055,54156,9.05
2024-12-14,D021,4043,73806,77849,73365,6.11
2024-12-16,D021,3431,62247,65678,67459,-2.64
2024-01-01,D022,6140,87832,93972,92072,2.06
2024-01-03,D022,6198,71288,77486,72619,6.7
2024-01-10,D022,4856,80431,85287,81218,5.01
2024-01-13,D022,6628,60878,67506,67521,-0.02
2024-01-15,D022,5825,90232,96057,92503,3.84
2024-01-18,D022,6855,52689,59544,57954,2.74
2024-01-26,D022,4753,67800,72553,72589,-0.05
2024-01-31,D022,5384,66566,71950,67760,6.18
2024-02-01,D022,3185,77821,81006,78321,3.43
2024-02-01,D022,4146,92517,96663,95925,0.77
2024-02-03,D022,3622,57943,61565,60558,1.66
2024-02-04,D022,3960,82482,86442,82686,4.54
2024-02-05,D022,4708,63731,68439,64250,6.52
2024-02-06,D022,6423,52920,59343,61261,-3.13
2024-02-09,D022,4636,60350,64986,65554,-0.87
2024-02-11,D022,3201,93977,97178,92767,4.75
2024-02-12,D022,5513,66040,71553,70283,1.81
2024-02-13,D022,4865,65734,70599,72130,-2.12
2024-02-16,D022,6076,55067,61143,56719,7.8
2024-02-22,D022,5260,94097,99357,94958,4.63
2024-02-24,D022,4736,64329,69065,69572,-0.73
2024-02-29,D022,4855,71852,76707,75857,1.12
2024-03-01,D022,6191,90244,96435,97874,-1.47
2024-03-01,D022,6434,89501,95935,95353,0.61
2024-03-02,D022,5985,69275,75260,76555,-1.69
2024-03-09,D022,6383,71792,78175,79390,-1.53
2024-03-10,D022,4903,64551,69454,69279,0.25
2024-03-10,D022,5940,70884,76824,79217,-3.02
2024-03-10,D022,6231,90175,96406,95812,0.62
2024-03-13,D022,3580,83744,87324,86052,1.48
2024-03-14,D022,6634,63890,70524,73016,-3.41
2024-03-25,D022,5841,78756,84597,81557,3.73
2024-04-09,D022,3749,63580,67329,68473,-1.67
2024-04-10,D022,3550,89713,93263,93863,-0.64
2024-04-17,D022,4296,77387,81683,80593,1.35
2024-04-21,D022,4986,66202,71188,70644,0.77
2024-04-22,D022,6772,63423,70195,67901,3.38
2024-04-26,D022,4578,67263,71841,72679,-1.15
2024-04-27,D022,4300,73253,77553,79310,-2.22
2024-04-30,D022,5737,73340,79077,76628,3.2
2024-05-09,D022,3030,73926,76956,75850,1.46
2024-05-12,D022,3749,82532,86281,83012,3.94
2024-05-12,D022,5398,78172,83570,78863,5.97
2024-05-18,D022,5465,99294,104759,101758,2.95
2024-05-18,D022,6769,57352,64121,61797,3.76
2024-05-21,D022,4982,87712,92694,87802,5.57
2024-05-25,D022,4547,80806,85353,84335,1.21
2024-06-01,D022,6793,76512,83305,79589,4.67
2024-06-02,D022,5203,66241,71444,68856,3.76
2024-06-02,D022,4962,82182,87144,86778,0.42
2024-06-04,D022,6701,69283,75984,78050,-2.65
2024-06-05,D022,5712,56073,61785,64644,-4.42
2024-06-07,D022,6350,87679,94029,96626,-2.69
2024-06-19,D022,4868,68055,72923,74841,-2.56
2024-06-23,D022,6873,98320,105193,101739,3.39
2024-07-07,D022,5710,89197,94907,93922,1.05
2024-07-08,D022,5120,60961,66081,67760,-2.48
2024-07-12,D022,5043,55580,60623,63409,-4.39
2024-07-21,D022,3607,95538,99145,100899,-1.74
2024-07-21,D022,5121,77160,82281,81085,1.47
2024-07-23,D022,6641,96792,103433,102625,0.79
2024-07-24,D022,6661,97431,104092,105459,-1.3
2024-08-01,D022,4909,82267,87176,83311,4.64
2024-08-05,D022,4245,96607,100852,103575,-2.63
2024-08-11,D022,3783,89876,93659,95710,-2.14
2024-08-19,D022,6672,93982,100654,98970,1.7
2024-08-20,D022,3682,96612,100294,103280,-2.89
2024-08-21,D022,5794,64648,70442,73078,-3.61
2024-08-25,D022,4693,64373,69066,65693,5.13
2024-08-26,D022,4079,95162,99241,99363,-0.12
2024-08-27,D022,5191,75184,80375,80103,0.34
2024-08-28,D022,5970,91791,97761,98968,-1.22
2024-08-29,D022,5569,66373,71942,69453,3.58
2024-08-29,D022,4074,75319,79393,74455,6.63
2024-09-03,D022,3778,77386,81164,77019,5.38
2024-09-03,D022,5896,50533,56429,53371,5.73
2024-09-12,D022,6792,70067,76859,73155,5.06
2024-10-10,D022,5625,93689,99314,95614,3.87
2024-10-13,D022,3894,75046,78940,75266,4.88
2024-10-13,D022,5438,91576,97014,95770,1.3
2024-10-17,D022,6605,67600,74205,73154,1.44
2024-10-30,D022,6676,60666,67342,68663,-1.92
2024-11-04,D022,3769,52433,56202,53891,4.29
2024-11-09,D022,5617,81024,86641,87926,-1.46
2024-11-11,D022,3227,83178,86405,86406,0
2024-11-15,D022,4556,73424,77980,76388,2.08
2024-11-15,D022,6797,85489,92286,93824,-1.64
2024-11-16,D022,3796,75135,78931,78343,0.75
2024-11-21,D022,4153,69201,73354,73693,-0.46
2024-11-21,D022,4777,85969,90746,93397,-2.84
2024-11-23,D022,6169,66968,73137,69667,4.98
2024-11-30,D022,4634,90878,95512,94379,1.2
2024-12-02,D022,5915,87261,93176,88871,4.84
2024-12-05,D022,6672,69790,76462,77675,-1.56
2024-12-13,D022,6868,98908,105776,105239,0.51
2024-12-14,D022,5294,58130,63424,63277,0.23
2024-12-24,D022,4228,54792,59020,55190,6.94
2024-12-26,D022,6671,78312,84983,80691,5.32
2024-12-27,D022,5193,67326,72519,72239,0.39
2024-12-29,D022,6094,52365,58459,54791,6.69
2024-12-29,D022,4303,95648,99951,100190,-0.24
2024-01-02,D023,6447,69477,75924,78042,-2.71
2024-01-17,D023,6336,55745,62081,60694,2.29
2024-01-19,D023,4069,91410,95479,97582,-2.16
2024-01-23,D023,3209,52093,55302,54764,0.98
2024-01-26,D023,6553,76029,82582,80749,2.27
2024-01-30,D023,6337,60567,66904,64293,4.06
2024-01-30,D023,4194,90899,95093,94489,0.64
2024-01-31,D023,4144,50068,54212,53495,1.34
2024-02-02,D023,4299,73641,77940,76229,2.24
2024-02-11,D023,4377,54857,59234,54570,8.55
2024-02-15,D023,5871,66006,71877,71688,0.26
2024-02-18,D023,6493,71806,78299,75084,4.28
2024-02-18,D023,3471,53815,57286,60040,-4.59
2024-02-22,D023,5724,54809,60533,55908,8.27
2024-02-23,D023,4161,62047,66208,64560,2.55
2024-02-23,D023,5853,52377,58230,60383,-3.57
2024-02-25,D023,3389,95397,98786,96745,2.11
2024-02-26,D023,6050,82720,88770,89537,-0.86
2024-02-27,D023,3541,56033,59574,57457,3.68
2024-02-28,D023,6582,69288,75870,73774,2.84
2024-03-08,D023,3595,83746,87341,83132,5.06
2024-03-15,D023,5324,75515,80839,80123,0.89
2024-03-23,D023,5025,94966,99991,98552,1.46
2024-03-25,D023,5698,96118,101816,98568,3.3
2024-04-02,D023,5664,50051,55715,58397,-4.59
2024-04-03,D023,4777,85052,89829,87777,2.34
2024-04-03,D023,4393,51268,55661,50692,9.8
2024-04-12,D023,4831,63798,68629,70455,-2.59
2024-04-13,D023,3945,66984,70929,71229,-0.42
2024-04-14,D023,3545,89291,92836,91631,1.32
2024-04-16,D023,5668,97680,103348,105191,-1.75
2024-04-16,D023,3172,52553,55725,51428,8.36
2024-04-18,D023,3618,66016,69634,65098,6.97
2024-04-18,D023,3316,53239,56555,53624,5.47
2024-04-20,D023,6999,93610,100609,103433,-2.73
2024-04-23,D023,5796,68792,74588,77248,-3.44
2024-04-26,D023,5665,70446,76111,76755,-0.84
2024-05-02,D023,6215,83757,89972,88688,1.45
2024-05-05,D023,5314,74343,79657,80522,-1.07
2024-05-07,D023,5238,59794,65032,61373,5.96
2024-05-09,D023,4468,74309,78777,80969,-2.71
2024-05-10,D023,3854,70860,74714,70438,6.07
2024-05-12,D023,6126,62120,68246,69703,-2.09
2024-05-12,D023,6398,75784,82182,81605,0.71
2024-05-13,D023,4731,50785,55516,52377,5.99
2024-05-14,D023,4106,83158,87264,89194,-2.16
2024-05-15,D023,6576,90868,97444,92517,5.33
2024-05-16,D023,6385,86538,92923,93655,-0.78
2024-05-16,D023,4409,53646,58055,55968,3.73
2024-05-17,D023,5098,90498,95596,97097,-1.55
2024-05-17,D023,5219,89809,95028,95968,-0.98
2024-05-18,D023,4645,96049,100694,96856,3.96
2024-05-21,D023,4669,89896,94565,93703,0.92
2024-05-24,D023,6136,69702,75838,76056,-0.29
2024-05-29,D023,5499,96241,101740,100525,1.21
2024-06-03,D023,4209,76872,81081,83333,-2.7
2024-06-06,D023,6052,50726,56778,56018,1.36
2024-06-10,D023,4930,57637,62567,60726,3.03
2024-06-17,D023,6152,57216,63368,62848,0.83
2024-06-19,D023,4718,57169,61887,57526,7.58
2024-06-22,D023,3215,96172,99387,98032,1.38
2024-06-24,D023,5230,56511,61741,64613,-4.44
2024-06-24,D023,3895,66021,69916,66500,5.14
2024-06-29,D023,6319,73155,79474,82196,-3.31
2024-06-29,D023,6364,86110,92474,94064,-1.69
2024-07-03,D023,5650,89159,94809,96572,-1.83
2024-07-07,D023,5502,52413,57915,59602,-2.83
2024-07-10,D023,4986,60377,65363,63923,2.25
2024-07-12,D023,6269,84140,90409,87367,3.48
2024-07-19,D023,3848,60748,64596,62155,3.93
2024-07-21,D023,3703,52808,56511,52869,6.89
2024-07-27,D023,6092,52808,58900,56241,4.73
2024-07-31,D023,3375,81449,84824,80411,5.49
2024-08-01,D023,3584,97719,101303,104146,-2.73
2024-08-05,D023,4948,94859,99807,100797,-0.98
2024-08-05,D023,3088,90144,93232,91866,1.49
2024-08-08,D023,6086,96010,102096,102790,-0.68
2024-08-08,D023,4876,73023,77899,75543,3.12
2024-08-08,D023,3234,74394,77628,73827,5.15
2024-08-11,D023,6296,96717,103013,100764,2.23
2024-08-12,D023,5063,67205,72268,67743,6.68
2024-08-23,D023,4304,94648,98952,97979,0.99
2024-08-25,D023,4222,93023,97245,98401,-1.17
2024-08-29,D023,4222,74014,78236,74656,4.8
2024-09-07,D023,5516,61663,67179,64027,4.92
2024-09-07,D023,6381,72223,78604,78724,-0.15
2024-09-11,D023,4494,95518,100012,95115,5.15
2024-09-13,D023,3909,84527,88436,85306,3.67
2024-09-13,D023,5861,72116,77977,77501,0.61
2024-09-14,D023,6249,85057,91306,86936,5.03
2024-09-20,D023,4489,59227,63716,63014,1.11
2024-09-22,D023,4982,83864,88846,85236,4.24
2024-09-26,D023,3969,51094,55063,51939,6.01
2024-09-26,D023,5151,94518,99669,96538,3.24
2024-09-28,D023,4048,76534,80582,81213,-0.78
2024-09-28,D023,5366,77467,82833,83861,-1.23
2024-10-09,D023,6550,83770,90320,91778,-1.59
2024-10-14,D023,3935,94940,98875,95481,3.55
2024-10-23,D023,4331,50337,54668,51604,5.94
2024-10-25,D023,6148,83691,89839,88607,1.39
2024-10-30,D023,3752,91559,95311,95289,0.02
2024-10-30,D023,3275,96060,99335,95678,3.82
2024-11-03,D023,5697,96253,101950,102491,-0.53
2024-11-05,D023,5709,89439,95148,91465,4.03
2024-11-09,D023,3305,85517,88822,86858,2.26
2024-11-21,D023,4999,64849,69848,70137,-0.41
2024-11-21,D023,6885,76987,83872,81886,2.43
2024-11-24,D023,4532,81239,85771,85647,0.14
2024-11-26,D023,5377,79816,85193,87981,-3.17
2024-11-28,D023,6915,62974,69889,71752,-2.6
2024-12-05,D023,3447,87066,90513,89745,0.86
2024-12-07,D023,3050,78312,81362,80593,0.95
2024-12-11,D023,6917,57307,64224,65063,-1.29
2024-12-13,D023,5674,98231,103905,102180,1.69
2024-12-18,D023,4770,62305,67075,68298,-1.79
2024-12-19,D023,6146,76401,82547,80523,2.51
2024-12-23,D023,5655,62204,67859,64346,5.46
2024-12-25,D023,5164,62644,67808,67804,0.01
2024-12-27,D023,3471,59271,62742,58974,6.39
2024-12-27,D023,6452,71360,77812,75117,3.59
2024-12-28,D023,3918,51375,55293,57112,-3.18
2024-12-29,D023,3038,78535,81573,77933,4.67
2024-12-30,D023,3922,56256,60178,59322,1.44
2024-12-31,D023,6357,77453,83810,81809,2.45
2024-01-03,D024,3159,57906,61065,59996,1.78
2024-01-04,D024,3151,50954,54105,51503,5.05
2024-01-04,D024,6906,66673,73579,74099,-0.7
2024-01-07,D024,3985,65797,69782,68551,1.8
2024-01-22,D024,4473,69627,74100,72622,2.04
2024-01-27,D024,4013,52837,56850,59443,-4.36
2024-01-28,D024,4507,99103,103610,102539,1.04
2024-01-28,D024,4571,97475,102046,104215,-2.08
2024-01-29,D024,3101,78794,81895,82794,-1.09
2024-01-29,D024,3170,81128,84298,86559,-2.61
2024-02-04,D024,3630,94557,98187,93517,4.99
2024-02-05,D024,5772,65261,71033,72602,-2.16
2024-02-09,D024,6020,50051,56071,56912,-1.48
2024-02-20,D024,5313,98247,103560,99705,3.87
2024-02-26,D024,3381,98055,101436,102591,-1.13
2024-03-05,D024,4031,73852,77883,80541,-3.3
2024-03-07,D024,6075,80720,86795,86434,0.42
2024-03-12,D024,5410,88396,93806,96670,-2.96
2024-03-14,D024,6948,85089,92037,89364,2.99
2024-03-18,D024,4369,74647,79016,77651,1.76
2024-03-18,D024,4311,97917,102228,102690,-0.45
2024-03-29,D024,6520,50256,56776,59105,-3.94
2024-03-30,D024,4564,88826,93390,89259,4.63
2024-04-07,D024,5795,76905,82700,78896,4.82
2024-04-08,D024,5035,87693,92728,94342,-1.71
2024-04-09,D024,5919,66023,71942,74812,-3.84
2024-04-13,D024,4781,98288,103069,99726,3.35
2024-04-17,D024,5235,63409,68644,71514,-4.01
2024-04-18,D024,4726,64837,69563,68633,1.36
2024-04-19,D024,6938,79732,86670,85607,1.24
2024-04-19,D024,3007,78349,81356,78546,3.58
2024-04-21,D024,3110,91543,94653,94428,0.24
2024-04-22,D024,5020,76027,81047,77903,4.04
2024-04-27,D024,6049,59497,65546,67631,-3.08
2024-05-04,D024,4360,91300,95660,98098,-2.49
2024-05-08,D024,5027,52695,57722,59227,-2.54
2024-05-11,D024,3625,91176,94801,97606,-2.87
2024-05-16,D024,5883,65696,71579,69187,3.46
2024-05-20,D024,3596,59909,63505,65150,-2.52
2024-05-22,D024,3943,89110,93053,94604,-1.64
2024-05-31,D024,6088,68052,74140,76993,-3.71
2024-05-31,D024,6065,53259,59324,61418,-3.41
2024-05-31,D024,6063,72751,78814,77215,2.07
2024-05-31,D024,5946,57532,63478,59112,7.39
2024-06-01,D024,4772,96390,101162,98229,2.99
2024-06-05,D024,5868,92348,98216,99019,-0.81
2024-06-06,D024,5980,68680,74660,70626,5.71
2024-06-06,D024,6533,58325,64858,64720,0.21
2024-06-07,D024,3568,55197,58765,54404,8.02
2024-06-09,D024,5470,86445,91915,87574,4.96
2024-06-10,D024,5394,61190,66584,64104,3.87
2024-06-10,D024,6741,99745,106486,103452,2.93
2024-06-10,D024,4151,60553,64704,63277,2.26
2024-06-16,D024,5317,70426,75743,71506,5.93
2024-06-22,D024,4193,98885,103078,98821,4.31
2024-06-24,D024,6462,88922,95384,96136,-0.78
2024-06-25,D024,4588,73088,77676,77748,-0.09
2024-06-25,D024,5427,89385,94812,94661,0.16
2024-06-29,D024,3234,91911,95145,92195,3.2
2024-06-30,D024,4169,79233,83402,83925,-0.62
2024-06-30,D024,6446,59182,65628,65563,0.1
2024-07-07,D024,5869,64141,70010,71858,-2.57
2024-07-10,D024,5523,56159,61682,57155,7.92
2024-07-13,D024,6741,95708,102449,104151,-1.63
2024-07-19,D024,4749,88091,92840,89808,3.38
2024-07-19,D024,5175,88174,93349,88359,5.65
2024-07-26,D024,4912,75868,80780,83180,-2.89
2024-07-29,D024,5269,81321,86590,83853,3.26
2024-07-29,D024,5928,61340,67268,68803,-2.23
2024-07-30,D024,3507,96577,100084,96057,4.19
2024-08-04,D024,3572,50178,53750,55025,-2.32
2024-08-13,D024,3981,59346,63327,65740,-3.67
2024-08-16,D024,6959,76469,83428,85115,-1.98
2024-08-21,D024,5892,83966,89858,90486,-0.69
2024-08-29,D024,4877,91045,95922,95807,0.12
2024-08-30,D024,6711,53688,60399,55710,8.42
2024-09-02,D024,3238,58183,61421,58497,5
2024-09-03,D024,5820,65900,71720,73649,-2.62
2024-09-06,D024,5834,62452,68286,70288,-2.85
2024-09-09,D024,6439,65077,71516,74011,-3.37
2024-09-30,D024,3034,56360,59394,57578,3.15
2024-10-10,D024,6935,82874,89809,88760,1.18
2024-10-11,D024,4992,91266,96258,97571,-1.35
2024-10-13,D024,3922,95697,99619,98019,1.63
2024-10-18,D024,4969,58947,63916,61162,4.5
2024-10-19,D024,5146,69115,74261,71270,4.2
2024-10-20,D024,4979,54666,59645,54828,8.79
2024-10-29,D024,3679,87298,90977,93296,-2.49
2024-10-31,D024,3145,64086,67231,65620,2.46
2024-11-01,D024,4799,72440,77239,77802,-0.72
2024-11-04,D024,5943,61698,67641,68262,-0.91
2024-11-06,D024,4160,63046,67206,63164,6.4
2024-11-06,D024,3536,80598,84134,84448,-0.37
2024-11-08,D024,4561,83541,88102,83791,5.14
2024-11-11,D024,3377,65251,68628,63903,7.39
2024-11-13,D024,3753,82103,85856,83408,2.93
2024-11-15,D024,3117,53006,56123,52098,7.73
2024-11-16,D024,5321,50555,55876,53937,3.59
2024-11-28,D024,6295,94132,100427,101248,-0.81
2024-11-28,D024,3480,61526,65006,65666,-1.01
2024-12-01,D024,4432,77126,81558,76664,6.38
2024-12-04,D024,4799,62254,67053,67345,-0.43
2024-12-08,D024,3134,81624,84758,82510,2.72
2024-12-12,D024,4283,66087,70370,65924,6.74
2024-12-16,D024,3528,70221,73749,76472,-3.56
2024-12-20,D024,4963,69567,74530,71583,4.12
2024-12-23,D024,4419,93835,98254,101195,-2.91
2024-12-29,D024,3522,78099,81621,80095,1.91
2024-12-30,D024,5627,61969,67596,64881,4.18
2024-12-30,D024,3674,51007,54681,52236,4.68
2024-12-31,D024,6191,81376,87567,85744,2.13
2024-01-01,D025,4158,72200,76358,73888,3.34
2024-01-02,D025,4526,68261,72787,71815,1.35
2024-01-04,D025,3473,77825,81298,78792,3.18
2024-01-11,D025,4343,78797,83140,79691,4.33
2024-01-13,D025,5875,72009,77884,77934,-0.06
2024-01-17,D025,5871,73089,78960,75170,5.04
2024-01-18,D025,6261,77281,83542,79060,5.67
2024-01-21,D025,6977,61434,68411,70373,-2.79
2024-01-26,D025,3176,90364,93540,89300,4.75
2024-01-28,D025,5113,93006,98119,95551,2.69
2024-02-01,D025,3648,75755,79403,76010,4.46
2024-02-02,D025,5102,54025,59127,59561,-0.73
2024-02-08,D025,6874,95186,102060,101491,0.56
2024-02-10,D025,3907,65324,69231,65615,5.51
2024-02-22,D025,3148,91462,94610,96741,-2.2
2024-02-27,D025,4515,66958,71473,70031,2.06
2024-03-01,D025,6854,57773,64627,63737,1.4
2024-03-01,D025,3938,68023,71961,68776,4.63
2024-03-06,D025,3669,70354,74023,69478,6.54
2024-03-08,D025,6465,58258,64723,67491,-4.1
2024-03-09,D025,5885,92756,98641,96919,1.78
2024-03-13,D025,3253,78610,81863,78833,3.84
2024-03-20,D025,4849,52642,57491,58891,-2.38
2024-04-02,D025,3326,70208,73534,72628,1.25
2024-04-03,D025,4736,62820,67556,63434,6.5
2024-04-05,D025,5988,78835,84823,83580,1.49
2024-04-06,D025,3528,71164,74692,73647,1.42
2024-04-11,D025,4579,81758,86337,86542,-0.24
2024-04-12,D025,3701,53307,57008,54479,4.64
2024-04-21,D025,4434,66589,71023,66671,6.53
2024-04-28,D025,3484,60267,63751,66038,-3.46
2024-04-29,D025,5998,56318,62316,61198,1.83
2024-05-02,D025,5964,61108,67072,62803,6.8
2024-05-04,D025,5160,96036,101196,96892,4.44
2024-05-06,D025,4960,76910,81870,80009,2.33
2024-05-10,D025,5407,89451,94858,97048,-2.26
2024-05-21,D025,4226,79492,83718,84956,-1.46
2024-05-23,D025,3110,71493,74603,73276,1.81
2024-05-27,D025,4141,75425,79566,82200,-3.2
2024-05-31,D025,5142,58102,63244,60567,4.42
2024-06-02,D025,6453,73172,79625,82399,-3.37
2024-06-29,D025,4193,70670,74863,74125,1
2024-06-30,D025,4148,50066,54214,51065,6.17
2024-07-05,D025,5335,91297,96632,95683,0.99
2024-07-07,D025,3256,99601,102857,104964,-2.01
2024-07-07,D025,4666,61258,65924,61545,7.12
2024-07-11,D025,5996,74557,80553,77459,3.99
2024-07-13,D025,4887,86034,90921,93255,-2.5
2024-07-16,D025,3793,75287,79080,74814,5.7
2024-07-20,D025,6042,71494,77536,77842,-0.39
2024-07-20,D025,4808,89971,94779,94234,0.58
2024-07-22,D025,3242,89278,92520,90489,2.24
2024-07-23,D025,3581,91800,95381,92449,3.17
2024-07-26,D025,3132,55315,58447,56066,4.25
2024-08-07,D025,4977,80496,85473,84034,1.71
2024-08-26,D025,6261,67046,73307,71102,3.1
2024-09-04,D025,4858,63788,68646,69165,-0.75
2024-09-04,D025,4277,70354,74631,75640,-1.33
2024-09-05,D025,5951,89492,95443,97390,-2
2024-09-05,D025,4727,96103,100830,98238,2.64
2024-09-09,D025,3018,52759,55777,50878,9.63
2024-09-12,D025,6039,98893,104932,107205,-2.12
2024-09-14,D025,3274,68157,71431,67244,6.23
2024-09-21,D025,3981,57382,61363,60832,0.87
2024-09-27,D025,4957,73958,78915,74056,6.56
2024-09-28,D025,4528,83706,88234,90473,-2.47
2024-10-03,D025,6068,77384,83452,85777,-2.71
2024-10-07,D025,5300,79984,85284,84025,1.5
2024-10-13,D025,6505,75363,81868,82073,-0.25
2024-10-17,D025,5722,64101,69823,67795,2.99
2024-10-18,D025,5374,96025,101399,98070,3.39
2024-10-20,D025,6045,80129,86174,89137,-3.32
2024-10-20,D025,6924,88551,95475,96916,-1.49
2024-10-29,D025,4829,97246,102075,97717,4.46
2024-10-30,D025,4958,62846,67804,66487,1.98
2024-11-06,D025,6720,71264,77984,77764,0.28
2024-11-11,D025,3974,79790,83764,82527,1.5
2024-11-11,D025,3570,54820,58390,53555,9.03
2024-11-15,D025,6989,95454,102443,103529,-1.05
2024-11-17,D025,4729,84959,89688,84936,5.59
2024-11-18,D025,6182,61009,67191,64055,4.9
2024-11-21,D025,3830,75763,79593,78624,1.23
2024-11-23,D025,5884,89958,95842,95015,0.87
2024-11-26,D025,6538,58027,64565,61805,4.47
2024-12-03,D025,6773,63495,70268,67058,4.79
2024-12-07,D025,5874,56938,62812,61028,2.92
2024-12-12,D025,6815,74187,81002,79628,1.73
2024-12-20,D025,5675,63663,69338,67554,2.64
2024-12-24,D025,3339,62676,66015,66391,-0.57
2024-12-24,D025,6272,67685,73957,69555,6.33
2024-01-13,D026,5231,60350,65581,62535,4.87
2024-01-15,D026,4837,90376,95213,94492,0.76
2024-01-15,D026,3272,87649,90921,89967,1.06
2024-01-16,D026,5658,78179,83837,85256,-1.66
2024-01-17,D026,3727,51115,54842,53264,2.96
2024-01-21,D026,6299,53201,59500,54646,8.88
2024-01-24,D026,6849,71260,78109,77401,0.91
2024-01-27,D026,4112,57048,61160,57976,5.49
2024-01-28,D026,5855,88533,94388,97362,-3.05
2024-01-29,D026,6734,97860,104594,100669,3.9
2024-02-05,D026,6631,57764,64395,62248,3.45
2024-02-11,D026,5939,98702,104641,106778,-2
2024-02-12,D026,5994,87997,93991,94981,-1.04
2024-02-13,D026,4952,65116,70068,69407,0.95
2024-02-19,D026,4281,60679,64960,61547,5.55
2024-02-24,D026,5614,57296,62910,60911,3.28
2024-02-25,D026,4813,62818,67631,64329,5.13
2024-02-25,D026,6432,62215,68647,63681,7.8
2024-02-29,D026,6382,75103,81485,81187,0.37
2024-03-01,D026,4635,96433,101068,103676,-2.52
2024-03-02,D026,4692,82969,87661,84501,3.74
2024-03-05,D026,4911,54611,59522,61342,-2.97
2024-03-06,D026,4660,54414,59074,60964,-3.1
2024-03-07,D026,5502,86587,92089,88234,4.37
2024-03-11,D026,6059,74070,80129,75250,6.48
2024-03-11,D026,3614,54050,57664,60339,-4.43
2024-03-12,D026,6037,62417,68454,64730,5.75
2024-03-13,D026,4138,70530,74668,72180,3.45
2024-03-27,D026,4113,56533,60646,58969,2.84
2024-03-27,D026,6153,69517,75670,77872,-2.83
2024-03-28,D026,4227,56159,60386,56068,7.7
2024-03-28,D026,3791,56895,60686,60283,0.67
2024-04-03,D026,3012,69404,72416,73559,-1.55
2024-04-10,D026,5472,60826,66298,64397,2.95
2024-04-11,D026,4750,68351,73101,72013,1.51
2024-04-12,D026,6703,63494,70197,66631,5.35
2024-04-19,D026,5467,69256,74723,74651,0.1
2024-04-23,D026,6216,74089,80305,79586,0.9
2024-04-25,D026,6376,69968,76344,72699,5.01
2024-04-29,D026,4266,52945,57211,59051,-3.12
2024-05-09,D026,3570,57903,61473,62689,-1.94
2024-05-13,D026,4642,86656,91298,93458,-2.31
2024-05-15,D026,4953,94858,99811,98698,1.13
2024-05-21,D026,4336,70644,74980,75619,-0.85
2024-05-21,D026,6322,56437,62759,65150,-3.67
2024-05-23,D026,6506,63284,69790,65537,6.49
2024-05-29,D026,5422,80782,86204,84605,1.89
2024-06-02,D026,6757,62379,69136,64536,7.13
2024-06-09,D026,3288,72727,76015,77204,-1.54
2024-06-15,D026,5515,76784,82299,78886,4.33
2024-06-17,D026,5070,63358,68428,64760,5.66
2024-06-24,D026,5218,63786,69004,67297,2.54
2024-06-25,D026,6370,61939,68309,69204,-1.29
2024-06-30,D026,6084,75938,82022,83202,-1.42
2024-07-04,D026,4310,59819,64129,59856,7.14
2024-07-09,D026,3460,74355,77815,74008,5.14
2024-07-12,D026,4359,99573,103932,105159,-1.17
2024-07-14,D026,3545,87487,91032,90197,0.93
2024-07-24,D026,6897,60728,67625,63077,7.21
2024-07-26,D026,5851,52843,58694,56969,3.03
2024-08-07,D026,4675,60707,65382,62190,5.13
2024-08-11,D026,3973,70654,74627,73657,1.32
2024-08-17,D026,6904,70307,77211,75997,1.6
2024-08-17,D026,5302,52283,57585,53392,7.85
2024-08-18,D026,3967,64610,68577,71332,-3.86
2024-08-19,D026,3834,54353,58187,53355,9.06
2024-08-22,D026,5709,66788,72497,70121,3.39
2024-08-25,D026,4187,70932,75119,73927,1.61
2024-08-25,D026,5022,81253,86275,81429,5.95
2024-08-25,D026,4037,95429,99466,95766,3.86
2024-08-28,D026,5553,64199,69752,68907,1.23
2024-08-28,D026,4805,88897,93702,94948,-1.31
2024-09-01,D026,3651,59286,62937,65892,-4.48
2024-09-16,D026,6584,60310,66894,63273,5.72
2024-09-29,D026,5415,99402,104817,100815,3.97
2024-09-30,D026,6369,72578,78947,77352,2.06
2024-10-05,D026,4482,56729,61211,57250,6.92
2024-10-10,D026,6935,55313,62248,59842,4.02
2024-10-18,D026,3489,94516,98005,95129,3.02
2024-10-20,D026,4269,57868,62137,59462,4.5
2024-10-26,D026,6370,51908,58278,57758,0.9
2024-11-03,D026,5046,65611,70657,66482,6.28
2024-11-08,D026,5173,67194,72367,73132,-1.05
2024-11-15,D026,3711,83971,87682,83682,4.78
2024-11-17,D026,6467,82021,88488,90960,-2.72
2024-11-19,D026,6301,86375,92676,93551,-0.94
2024-11-20,D026,4528,80268,84796,87659,-3.27
2024-11-29,D026,5984,52936,58920,58058,1.48
2024-11-30,D026,6929,99311,106240,101997,4.16
2024-11-30,D026,4067,99178,103245,99308,3.96
2024-12-08,D026,6845,57222,64067,59134,8.34
2024-12-10,D026,5057,52311,57368,52933,8.38
2024-12-11,D026,4401,89433,93834,94770,-0.99
2024-12-13,D026,4612,53275,57887,60332,-4.05
2024-12-15,D026,3475,51049,54524,53395,2.11
2024-12-20,D026,6783,71811,78594,74583,5.38
2024-12-21,D026,3679,90128,93807,93037,0.83
2024-12-24,D026,6346,55171,61517,63120,-2.54
2024-12-30,D026,4561,77935,82496,80623,2.32
2024-12-30,D026,3861,58149,62010,58531,5.94
2024-01-01,D027,4754,50463,55217,50820,8.65
2024-01-07,D027,6141,81358,87499,89077,-1.77
2024-01-08,D027,6336,67166,73502,74995,-1.99
2024-01-13,D027,6368,67279,73647,72742,1.24
2024-01-25,D027,3975,61683,65658,65233,0.65
2024-01-27,D027,3072,67504,70576,68808,2.57
2024-01-30,D027,4748,77685,82433,83557,-1.35
2024-02-03,D027,4522,52176,56698,55955,1.33
2024-02-06,D027,5861,92608,98469,93755,5.03
2024-02-09,D027,5391,74852,80243,77135,4.03
2024-02-10,D027,3949,79267,83216,82662,0.67
2024-02-12,D027,4154,90151,94305,95676,-1.43
2024-02-26,D027,5785,52243,58028,55149,5.22
2024-02-27,D027,6885,60776,67661,63421,6.69
2024-02-29,D027,6038,70114,76152,76486,-0.44
2024-02-29,D027,5165,50422,55587,51888,7.13
2024-02-29,D027,3544,80132,83676,82454,1.48
2024-03-12,D027,4083,89341,93424,95440,-2.11
2024-03-13,D027,5841,60488,66329,63139,5.05
2024-03-14,D027,5402,99648,105050,104651,0.38
2024-03-21,D027,4639,65169,69808,71416,-2.25
2024-03-22,D027,5371,65417,70788,73635,-3.87
2024-03-25,D027,4899,90950,95849,93347,2.68
2024-03-29,D027,6217,68101,74318,72966,1.85
2024-03-31,D027,4377,65223,69600,65899,5.62
2024-04-09,D027,6244,77703,83947,84674,-0.86
2024-04-11,D027,4140,50615,54755,53103,3.11
2024-04-11,D027,3290,52251,55541,53220,4.36
2024-04-26,D027,4889,74842,79731,80886,-1.43
2024-04-29,D027,5477,85790,91267,91683,-0.45
2024-04-30,D027,5675,59474,65149,60623,7.47
2024-05-01,D027,6282,96359,102641,98960,3.72
2024-05-04,D027,3500,76675,80175,83073,-3.49
2024-05-07,D027,5153,62502,67655,65465,3.35
2024-05-08,D027,6670,73369,80039,79542,0.62
2024-05-13,D027,4865,77713,82578,84787,-2.61
2024-05-16,D027,5550,66038,71588,66710,7.31
2024-05-21,D027,6157,63775,69932,72887,-4.05
2024-05-22,D027,3222,67127,70349,72887,-3.48
2024-05-22,D027,5442,99262,104704,107615,-2.71
2024-05-25,D027,5993,57965,63958,65553,-2.43
2024-06-01,D027,4356,83782,88138,89006,-0.98
2024-06-05,D027,4518,80949,85467,82304,3.84
2024-06-05,D027,5597,82184,87781,89661,-2.1
2024-06-13,D027,6009,59454,65463,61671,6.15
2024-06-14,D027,5365,82017,87382,82832,5.49
2024-06-16,D027,3609,80987,84596,81728,3.51
2024-06-18,D027,5337,53239,58576,58161,0.71
2024-06-20,D027,4892,77974,82866,83107,-0.29
2024-06-20,D027,3869,71550,75419,78326,-3.71
2024-06-22,D027,6633,80707,87340,83998,3.98
2024-06-27,D027,4532,55691,60223,57082,5.5
2024-07-03,D027,6140,90764,96904,92607,4.64
2024-07-08,D027,6154,92879,99033,95208,4.02
2024-07-10,D027,5382,56229,61611,57734,6.72
2024-07-14,D027,4097,65584,69681,71023,-1.89
2024-07-29,D027,4388,86160,90548,90776,-0.25
2024-08-01,D027,5121,52108,57229,55436,3.23
2024-08-02,D027,3078,76074,79152,81226,-2.55
2024-08-05,D027,3444,92748,96192,94875,1.39
2024-08-13,D027,6348,82352,88700,85273,4.02
2024-08-14,D027,5575,98795,104370,104969,-0.57
2024-08-20,D027,5958,67211,73169,69790,4.84
2024-08-24,D027,4312,70695,75007,70693,6.1
2024-08-25,D027,4799,83458,88257,90764,-2.76
2024-09-03,D027,3729,89284,93013,95597,-2.7
2024-09-14,D027,5421,83548,88969,90253,-1.42
2024-09-18,D027,4808,63731,68539,69772,-1.77
2024-09-19,D027,5376,66746,72122,71184,1.32
2024-09-22,D027,4676,62523,67199,63158,6.4
2024-09-25,D027,5531,73194,78725,78581,0.18
2024-09-25,D027,4776,52462,57238,58970,-2.94
2024-09-27,D027,6035,67380,73415,74121,-0.95
2024-09-29,D027,6175,90864,97039,92479,4.93
2024-09-30,D027,3844,74533,78377,77396,1.27
2024-10-01,D027,6737,59780,66517,63195,5.26
2024-10-04,D027,6556,50594,57150,55120,3.68
2024-10-09,D027,3590,82766,86356,83141,3.87
2024-10-13,D027,3474,99769,103243,101507,1.71
2024-10-15,D027,5029,68768,73797,75988,-2.88
2024-10-15,D027,3723,77516,81239,77824,4.39
2024-10-23,D027,3408,72889,76297,71871,6.16
2024-10-30,D027,3413,67934,71347,69821,2.19
2024-11-03,D027,3248,81703,84951,86593,-1.9
2024-11-03,D027,6830,57838,64668,59786,8.17
2024-11-19,D027,4913,66654,71567,70501,1.51
2024-11-20,D027,4560,93360,97920,98677,-0.77
2024-11-20,D027,4284,85800,90084,88579,1.7
2024-11-29,D027,6223,74386,80609,78763,2.34
2024-11-30,D027,4529,68687,73216,72535,0.94
2024-12-08,D027,3615,72394,76009,76756,-0.97
2024-12-12,D027,6600,56783,63383,61349,3.32
2024-12-13,D027,5684,77050,82734,82604,0.16
2024-12-15,D027,6385,83690,90075,90900,-0.91
2024-12-15,D027,4876,60027,64903,62109,4.5
2024-12-17,D027,6641,74240,80881,82058,-1.43
2024-12-21,D027,4483,74054,78537,79463,-1.17
2024-12-28,D027,5495,99114,104609,106352,-1.64
2024-01-01,D028,3062,51783,54845,54031,1.51
2024-01-02,D028,6966,67424,74390,77076,-3.48
2024-01-02,D028,4380,50824,55204,52516,5.12
2024-01-04,D028,5697,65026,70723,73487,-3.76
2024-01-08,D028,4367,81106,85473,84929,0.64
2024-01-09,D028,4650,81385,86035,87882,-2.1
2024-01-18,D028,4848,79605,84453,83070,1.66
2024-01-23,D028,5627,50909,56536,51922,8.89
2024-01-25,D028,3057,92481,95538,98242,-2.75
2024-01-26,D028,3880,79118,82998,83885,-1.06
2024-01-26,D028,6337,66558,72895,70260,3.75
2024-01-29,D028,6720,67602,74322,72306,2.79
2024-01-30,D028,4113,82646,86759,87033,-0.31
2024-02-07,D028,5701,51933,57634,59888,-3.76
2024-02-09,D028,3192,88526,91718,90334,1.53
2024-02-12,D028,4704,94629,99333,98061,1.3
2024-02-15,D028,4259,79743,84002,80661,4.14
2024-02-16,D028,4958,60693,65651,62307,5.37
2024-02-17,D028,5655,53236,58891,57338,2.71
2024-02-18,D028,6491,67420,73911,72780,1.55
2024-02-21,D028,6876,87383,94259,92352,2.06
2024-02-29,D028,5382,75821,81203,82119,-1.12
2024-03-01,D028,6945,57597,64542,61798,4.44
2024-03-02,D028,5538,68660,74198,72059,2.97
2024-03-05,D028,6683,99737,106420,103597,2.72
2024-03-08,D028,3813,71473,75286,76255,-1.27
2024-03-10,D028,5042,92899,97941,100809,-2.84
2024-03-17,D028,6490,58872,65362,67390,-3.01
2024-04-03,D028,5504,91574,97078,96272,0.84
2024-04-09,D028,4317,61663,65980,63225,4.36
2024-04-16,D028,6098,79888,85986,84042,2.31
2024-04-16,D028,3463,82530,85993,83025,3.57
2024-04-24,D028,3312,55113,58425,61198,-4.53
2024-05-26,D028,4508,93027,97535,93099,4.76
2024-06-07,D028,3837,75613,79450,75673,4.99
2024-06-07,D028,6195,67889,74084,70624,4.9
2024-06-14,D028,3158,80733,83891,82423,1.78
2024-06-27,D028,4079,79850,83929,81138,3.44
2024-06-29,D028,5790,69091,74881,69922,7.09
2024-07-04,D028,4995,53866,58861,54192,8.62
2024-07-06,D028,5044,99570,104614,105865,-1.18
2024-07-08,D028,5681,86397,92078,89383,3.02
2024-07-15,D028,6262,54996,61258,60624,1.05
2024-07-20,D028,5515,90856,96371,94423,2.06
2024-07-27,D028,6903,53565,60468,61234,-1.25
2024-08-02,D028,3990,61138,65128,66316,-1.79
2024-08-09,D028,4809,93967,98776,98551,0.23
2024-08-10,D028,6028,82885,88913,91432,-2.76
2024-08-11,D028,3152,63523,66675,69584,-4.18
2024-08-17,D028,5671,93739,99410,95632,3.95
2024-08-17,D028,3763,66632,70395,70827,-0.61
2024-08-18,D028,5237,73776,79013,76509,3.27
2024-08-27,D028,4017,74398,78415,78673,-0.33
2024-09-01,D028,5625,86617,92242,93837,-1.7
2024-09-02,D028,5826,75226,81052,82176,-1.37
2024-09-04,D028,4241,74765,79006,76470,3.32
2024-09-07,D028,4326,96026,100352,95360,5.23
2024-09-09,D028,4910,78743,83653,82335,1.6
2024-09-09,D028,4419,60528,64947,66712,-2.65
2024-09-11,D028,5218,74532,79750,76903,3.7
2024-09-15,D028,6016,60246,66262,64979,1.97
2024-09-21,D028,4395,94517,98912,96359,2.65
2024-09-22,D028,3328,76415,79743,81557,-2.22
2024-09-23,D028,3610,54302,57912,59369,-2.45
2024-09-26,D028,6994,77624,84618,80795,4.73
2024-09-28,D028,6758,60704,67462,68311,-1.24
2024-09-29,D028,3042,85192,88234,90170,-2.15
2024-10-03,D028,4461,67514,71975,69198,4.01
2024-10-12,D028,3985,54079,58064,57716,0.6
2024-10-21,D028,6862,86163,93025,94822,-1.9
2024-10-22,D028,4569,78511,83080,78834,5.39
2024-10-28,D028,5143,73741,78884,79384,-0.63
2024-10-28,D028,3575,74133,77708,73238,6.1
2024-10-29,D028,6535,70714,77249,72386,6.72
2024-10-30,D028,3995,92919,96914,98313,-1.42
2024-11-13,D028,4107,63629,67736,66530,1.81
2024-11-16,D028,3558,78635,82193,79893,2.88
2024-11-23,D028,3726,75820,79546,79086,0.58
2024-11-25,D028,4393,51376,55769,52706,5.81
2024-12-02,D028,3489,58382,61871,58057,6.57
2024-12-02,D028,4246,85144,89390,89381,0.01
2024-12-07,D028,4873,58981,63854,62206,2.65
2024-12-07,D028,6639,69514,76153,72109,5.61
2024-12-18,D028,4717,77172,81889,80145,2.18
2024-12-20,D028,3254,71646,74900,74077,1.11
2024-12-21,D028,5301,57710,63011,60219,4.64
2024-12-21,D028,6498,76020,82518,84173,-1.97
2024-12-31,D028,4011,58244,62255,58704,6.05
2024-01-01,D029,6783,78088,84871,81584,4.03
2024-01-02,D029,5280,95424,100704,102430,-1.69
2024-01-04,D029,5000,73650,78650,75110,4.71
2024-01-08,D029,6499,50492,56991,56685,0.54
2024-01-10,D029,6729,75323,82052,84589,-3
2024-01-11,D029,6169,72449,78618,80524,-2.37
2024-01-11,D029,5144,51893,57037,54476,4.7
2024-01-12,D029,4630,53373,58003,57034,1.7
2024-01-14,D029,6586,66087,72673,67765,7.24
2024-01-15,D029,5571,77236,82807,78484,5.51
2024-01-16,D029,6426,58750,65176,60246,8.18
2024-01-16,D029,3309,85764,89073,88606,0.53
2024-01-17,D029,4177,87268,91445,87462,4.55
2024-01-19,D029,4407,58032,62439,64223,-2.78
2024-01-19,D029,5730,86289,92019,88802,3.62
2024-01-21,D029,3493,66465,69958,65959,6.06
2024-01-22,D029,3165,88197,91362,87344,4.6
2024-01-24,D029,3755,59638,63393,61462,3.14
2024-01-26,D029,4878,56572,61450,64216,-4.31
2024-01-27,D029,6473,88247,94720,90493,4.67
2024-02-04,D029,3074,61183,64257,63897,0.56
2024-02-05,D029,5572,66198,71770,73048,-1.75
2024-02-11,D029,5068,93404,98472,98800,-0.33
2024-02-12,D029,6875,88265,95140,90353,5.3
2024-02-12,D029,3253,87947,91200,91490,-0.32
2024-02-15,D029,6618,95445,102063,99350,2.73
2024-02-28,D029,5172,78001,83173,84877,-2.01
2024-02-28,D029,3582,85931,89513,91225,-1.88
2024-02-29,D029,6681,87034,93715,89166,5.1
2024-03-03,D029,6090,67754,73844,74916,-1.43
2024-03-05,D029,5368,89945,95313,93304,2.15
2024-03-08,D029,3708,52871,56579,54537,3.74
2024-03-10,D029,3378,75878,79256,78442,1.04
2024-03-13,D029,6817,57939,64756,62012,4.42
2024-03-15,D029,5931,96766,102697,100628,2.06
2024-03-22,D029,6294,75510,81804,81762,0.05
2024-03-29,D029,4160,87367,91527,88253,3.71
2024-04-04,D029,3785,96632,100417,96103,4.49
2024-04-06,D029,6081,74817,80898,80001,1.12
2024-04-07,D029,3916,64877,68793,66072,4.12
2024-04-12,D029,3123,69465,72588,70140,3.49
2024-04-13,D029,3338,90133,93471,90028,3.82
2024-04-18,D029,4540,88935,93475,90111,3.73
2024-04-21,D029,6813,57188,64001,59689,7.22
2024-04-22,D029,6065,60467,66532,68038,-2.21
2024-04-23,D029,5509,71400,76909,72599,5.94
2024-04-23,D029,5067,88032,93099,94868,-1.86
2024-04-25,D029,6506,98657,105163,106698,-1.44
2024-04-26,D029,5026,60655,65681,61744,6.38
2024-04-28,D029,3679,79536,83215,78347,6.21
2024-04-28,D029,5356,54790,60146,60811,-1.09
2024-05-10,D029,3237,55399,58636,55940,4.82
2024-05-12,D029,4162,95724,99886,99322,0.57
2024-05-13,D029,5161,67848,73009,75366,-3.13
2024-05-15,D029,5187,58744,63931,61838,3.38
2024-05-15,D029,6332,64382,70714,71343,-0.88
2024-05-17,D029,5231,69856,75087,72638,3.37
2024-05-19,D029,6666,66943,73609,68652,7.22
2024-05-22,D029,3608,99460,103068,99524,3.56
2024-05-30,D029,4720,86017,90737,88085,3.01
2024-06-05,D029,5657,71729,77386,73831,4.82
2024-06-08,D029,4969,78732,83701,79924,4.73
2024-06-11,D029,3059,90860,93919,93817,0.11
2024-06-13,D029,3848,98825,102673,99988,2.69
2024-06-15,D029,6771,70648,77419,72451,6.86
2024-06-23,D029,3075,65972,69047,71122,-2.92
2024-06-30,D029,3636,83785,87421,88195,-0.88
2024-07-04,D029,5117,64485,69602,65189,6.77
2024-07-12,D029,4020,60255,64275,65829,-2.36
2024-07-18,D029,3416,50637,54053,57013,-5.19
2024-07-20,D029,5721,66215,71936,72587,-0.9
2024-07-20,D029,6515,67297,73812,74801,-1.32
2024-07-22,D029,6747,75338,82085,79739,2.94
2024-07-24,D029,3178,70470,73648,75914,-2.98
2024-07-25,D029,3352,80027,83379,82491,1.08
2024-07-28,D029,6502,87606,94108,91236,3.15
2024-07-28,D029,4547,61560,66107,63858,3.52
2024-07-29,D029,4963,90167,95130,94285,0.9
2024-08-01,D029,3682,86674,90356,89719,0.71
2024-08-01,D029,5659,78672,84331,85753,-1.66
2024-08-02,D029,6756,85367,92123,89507,2.92
2024-08-03,D029,6302,52452,58754,56466,4.05
2024-08-05,D029,4301,80048,84349,84284,0.08
2024-08-07,D029,5004,95228,100232,100449,-0.22
2024-08-07,D029,4092,94078,98170,96066,2.19
2024-08-10,D029,4725,62213,66938,62683,6.79
2024-08-12,D029,4737,50737,55474,58239,-4.75
2024-08-18,D029,4588,78454,83042,83674,-0.76
2024-08-19,D029,5580,74370,79950,81377,-1.75
2024-08-31,D029,4893,92464,97357,94399,3.13
2024-09-02,D029,5281,79508,84789,86096,-1.52
2024-09-03,D029,4851,76355,81206,81074,0.16
2024-09-04,D029,5451,73580,79031,76120,3.82
2024-09-07,D029,5925,59824,65749,62076,5.92
2024-09-12,D029,3765,52911,56676,58877,-3.74
2024-09-17,D029,6148,83536,89684,91702,-2.2
2024-09-22,D029,5699,79485,85184,82267,3.55
2024-09-27,D029,4506,65222,69728,68557,1.71
2024-09-29,D029,6444,88459,94903,90330,5.06
2024-10-04,D029,4219,57059,61278,62391,-1.78
2024-10-05,D029,6540,59327,65867,64923,1.45
2024-10-08,D029,4563,52124,56687,53035,6.89
2024-10-12,D029,3793,66820,70613,67601,4.46
2024-10-15,D029,5035,75053,80088,81834,-2.13
2024-10-20,D029,5172,85556,90728,91853,-1.22
2024-10-20,D029,4171,98599,102770,99656,3.12
2024-10-22,D029,6368,53797,60165,56243,6.97
2024-10-26,D029,3132,70534,73666,72606,1.46
2024-10-28,D029,3180,99758,102938,102768,0.17
2024-10-31,D029,3735,78144,81879,78445,4.38
2024-11-03,D029,6038,85613,91651,86787,5.6
2024-11-04,D029,5704,83365,89069,90537,-1.62
2024-11-05,D029,3601,51620,55221,53341,3.52
2024-11-05,D029,6669,67584,74253,75459,-1.6
2024-11-11,D029,5494,62677,68171,68452,-0.41
2024-11-12,D029,4888,93675,98563,96778,1.84
2024-11-25,D029,5079,69542,74621,69903,6.75
2024-12-04,D029,3453,83362,86815,84363,2.91
2024-12-04,D029,3901,67376,71277,68990,3.31
2024-12-08,D029,5144,81795,86939,85669,1.48
2024-12-08,D029,4568,87555,92123,89067,3.43
2024-12-11,D029,3203,81676,84879,82207,3.25
2024-12-17,D029,4381,87380,91761,93243,-1.59
2024-12-17,D029,4822,87323,92145,92751,-0.65
2024-12-17,D029,4535,74329,78864,79804,-1.18
2024-12-18,D029,6235,77405,83640,84259,-0.73
2024-12-19,D029,4522,87004,91526,87625,4.45
2024-12-21,D029,5581,50691,56272,55253,1.84
2024-12-27,D029,3459,60492,63951,61306,4.31
2024-12-28,D029,5429,78208,83637,79193,5.61
2024-12-29,D029,4676,51196,55872,54767,2.02
2024-01-01,D030,4109,99581,103690,100990,2.67
2024-01-10,D030,5786,85001,90787,90142,0.72
2024-01-20,D030,3559,67352,70911,66614,6.45
2024-01-20,D030,4956,92626,97582,96158,1.48
2024-01-25,D030,5028,91243,96271,93703,2.74
2024-01-29,D030,5457,90146,95603,96914,-1.35
2024-02-08,D030,5286,56265,61551,60312,2.05
2024-02-14,D030,3079,87926,91005,93766,-2.94
2024-02-16,D030,5914,89734,95648,91569,4.45
2024-02-18,D030,5893,90110,96003,92980,3.25
2024-02-20,D030,4094,54575,58669,53942,8.76
2024-02-22,D030,5907,96314,102221,103239,-0.99
2024-02-24,D030,3360,85523,88883,88359,0.59
2024-02-25,D030,4083,67033,71116,69982,1.62
2024-02-29,D030,6468,83024,89492,91916,-2.64
2024-03-02,D030,3514,71059,74573,76013,-1.89
2024-03-09,D030,3392,67492,70884,69522,1.96
2024-03-13,D030,6333,78760,85093,82059,3.7
2024-03-20,D030,4061,83781,87842,87543,0.34
2024-03-21,D030,3998,99112,103110,99642,3.48
2024-03-31,D030,3747,96553,100300,102500,-2.15
2024-03-31,D030,5214,85774,90988,89686,1.45
2024-04-07,D030,4932,58699,63631,60868,4.54
2024-04-08,D030,6970,88077,95047,98036,-3.05
2024-04-15,D030,3132,82177,85309,80801,5.58
2024-04-21,D030,5449,91081,96530,95162,1.44
2024-04-24,D030,6161,86051,92212,87495,5.39
2024-04-29,D030,4938,78390,83328,82966,0.44
2024-04-29,D030,5106,74557,79663,74769,6.55
2024-05-04,D030,5257,90922,96179,91228,5.43
2024-05-05,D030,3656,51199,54855,51763,5.97
2024-05-08,D030,6162,53675,59837,57143,4.71
2024-05-17,D030,6549,99766,106315,106237,0.07
2024-05-25,D030,5101,78003,83104,83780,-0.81
2024-05-25,D030,3001,94976,97977,98341,-0.37
2024-05-26,D030,3656,58311,61967,64137,-3.38
2024-05-28,D030,4107,70421,74528,70979,5
2024-05-28,D030,4890,93397,98287,99276,-1
2024-06-03,D030,6494,83672,90166,91897,-1.88
2024-06-10,D030,3429,68021,71450,67214,6.3
2024-06-14,D030,5690,90091,95781,95526,0.27
2024-06-14,D030,3946,62342,66288,61478,7.82
2024-06-20,D030,3308,81625,84933,87591,-3.03
2024-06-21,D030,6411,91756,98167,95542,2.75
2024-06-21,D030,5015,87019,92034,91046,1.09
2024-06-24,D030,5821,87006,92827,92567,0.28
2024-06-25,D030,5050,94460,99510,101345,-1.81
2024-07-09,D030,4026,79692,83718,79064,5.89
2024-07-13,D030,6285,65728,72013,68016,5.88
2024-07-22,D030,3649,93307,96956,95466,1.56
2024-07-24,D030,5357,66650,72007,73569,-2.12
2024-07-27,D030,3637,80954,84591,81032,4.39
2024-07-31,D030,3158,50956,54114,55043,-1.69
2024-07-31,D030,6243,77935,84178,79576,5.78
2024-08-03,D030,6615,70270,76885,73654,4.39
2024-08-07,D030,5010,78457,83467,81521,2.39
2024-08-12,D030,6884,85645,92529,89947,2.87
2024-08-13,D030,4076,57083,61159,58173,5.13
2024-08-13,D030,3209,61659,64868,66938,-3.09
2024-08-17,D030,3657,81601,85258,82942,2.79
2024-08-18,D030,5796,51678,57474,57232,0.42
2024-08-19,D030,3900,62875,66775,67281,-0.75
2024-08-25,D030,3957,79124,83081,80758,2.88
2024-08-29,D030,6322,79548,85870,83746,2.54
2024-08-31,D030,3273,71435,74708,75061,-0.47
2024-09-02,D030,6693,66482,73175,73887,-0.96
2024-09-03,D030,6177,93088,99265,100085,-0.82
2024-09-10,D030,6701,85525,92226,91306,1.01
2024-09-11,D030,3513,88893,92406,87532,5.57
2024-09-14,D030,3712,94398,98110,93173,5.3
2024-09-23,D030,5011,89019,94030,92091,2.11
2024-09-29,D030,6952,64397,71349,73754,-3.26
2024-09-29,D030,3826,98521,102347,99361,3.01
2024-10-04,D030,6274,56411,62685,59320,5.67
2024-10-07,D030,5971,84785,90756,86352,5.1
2024-10-08,D030,6215,94748,100963,97269,3.8
2024-11-02,D030,3160,67809,70969,70308,0.94
2024-11-04,D030,3439,75654,79093,76666,3.17
2024-11-08,D030,5355,85464,90819,92102,-1.39
2024-11-18,D030,5011,75760,80771,80978,-0.26
2024-11-19,D030,3145,97037,100182,98794,1.4
2024-11-26,D030,5664,79075,84739,85184,-0.52
2024-11-26,D030,6517,60589,67106,64380,4.23
2024-11-28,D030,6811,78756,85567,87883,-2.64
2024-11-30,D030,6107,98171,104278,102004,2.23
2024-12-08,D030,6264,52728,58992,61077,-3.41
2024-12-09,D030,3083,89351,92434,91692,0.81
2024-12-12,D030,6920,53574,60494,59765,1.22
2024-12-14,D030,3531,61552,65083,62475,4.17
2024-12-18,D030,6863,88157,95020,94657,0.38
2024-12-28,D030,6251,57076,63327,65256,-2.96
2024-12-28,D030,5614,70236,75850,73391,3.35
2024-01-01,D031,4396,94597,98993,98663,0.33
2024-01-06,D031,6393,91427,97820,94969,3
2024-01-08,D031,3899,95415,99314,99367,-0.05
2024-01-10,D031,6185,81819,88004,84185,4.54
2024-01-13,D031,6929,64219,71148,72531,-1.91
2024-01-17,D031,3116,79654,82770,79294,4.38
2024-01-19,D031,4171,74022,78193,78655,-0.59
2024-01-21,D031,6161,78967,85128,85969,-0.98
2024-01-23,D031,3425,90329,93754,94035,-0.3
2024-02-02,D031,5670,75745,81415,79427,2.5
2024-02-04,D031,4728,63767,68495,67836,0.97
2024-02-09,D031,3228,60787,64015,66096,-3.15
2024-02-10,D031,5973,57637,63610,65950,-3.55
2024-02-13,D031,6486,90633,97119,96193,0.96
2024-02-14,D031,5696,93241,98937,100882,-1.93
2024-02-16,D031,6717,66491,73208,73577,-0.5
2024-02-21,D031,5904,92571,98475,100579,-2.09
2024-02-25,D031,4486,75032,79518,77440,2.68
2024-02-28,D031,5539,87376,92915,92201,0.77
2024-02-28,D031,6641,54747,61388,62165,-1.25
2024-03-04,D031,3767,83327,87094,82648,5.38
2024-03-06,D031,3879,74643,78522,80306,-2.22
2024-03-09,D031,6234,90430,96664,92114,4.94
2024-03-14,D031,6602,61419,68021,69149,-1.63
2024-03-20,D031,6102,87848,93950,89671,4.77
2024-03-20,D031,3745,92679,96424,98997,-2.6
2024-03-21,D031,4518,97560,102078,100461,1.61
2024-03-25,D031,5463,77105,82568,83065,-0.6
2024-03-27,D031,3710,50869,54579,51500,5.98
2024-03-28,D031,4067,93285,97352,96598,0.78
2024-03-31,D031,5527,64908,70435,70930,-0.7
2024-04-01,D031,6093,60411,66504,63781,4.27
2024-04-10,D031,5724,85278,91002,89366,1.83
2024-04-16,D031,6159,52176,58335,56333,3.55
2024-04-16,D031,5143,58026,63169,58588,7.82
2024-04-17,D031,3210,60686,63896,62215,2.7
2024-04-20,D031,6707,82668,89375,85801,4.17
2024-04-26,D031,3706,76201,79907,76074,5.04
2024-04-28,D031,3349,85732,89081,91395,-2.53
2024-04-29,D031,3178,81153,84331,85371,-1.22
2024-05-03,D031,4972,57670,62642,60875,2.9
2024-05-04,D031,5088,72394,77482,80229,-3.42
2024-05-04,D031,4133,90724,94857,90164,5.2
2024-06-02,D031,4937,67401,72338,72185,0.21
2024-06-03,D031,6855,63065,69920,68465,2.13
2024-06-04,D031,5225,61258,66483,63532,4.64
2024-06-04,D031,5107,57928,63035,58993,6.85
2024-06-05,D031,5088,88700,93788,94984,-1.26
2024-06-17,D031,6133,94380,100513,102048,-1.5
2024-06-25,D031,3456,89612,93068,93042,0.03
2024-06-29,D031,4697,80847,85544,85730,-0.22
2024-06-29,D031,3287,72337,75624,74342,1.72
2024-07-06,D031,3059,93922,96981,96093,0.92
2024-07-10,D031,5812,71029,76841,77780,-1.21
2024-07-16,D031,3602,58631,62233,64249,-3.14
2024-07-16,D031,3381,77312,80693,79337,1.71
2024-07-17,D031,3208,96290,99498,102460,-2.89
2024-07-17,D031,5258,54382,59640,56829,4.95
2024-07-19,D031,4642,60489,65131,60555,7.56
2024-07-20,D031,5079,87306,92385,89080,3.71
2024-07-23,D031,6573,52978,59551,60104,-0.92
2024-07-24,D031,3709,93403,97112,99201,-2.11
2024-07-26,D031,4137,77103,81240,80123,1.39
2024-08-04,D031,6316,67743,74059,73285,1.06
2024-08-06,D031,5059,73341,78400,77914,0.62
2024-08-09,D031,5050,87853,92903,90266,2.92
2024-08-12,D031,4781,87443,92224,93747,-1.62
2024-08-19,D031,6865,76140,83005,84787,-2.1
2024-08-23,D031,4688,50467,55155,55539,-0.69
2024-08-26,D031,3926,94398,98324,96037,2.38
2024-08-28,D031,6065,81897,87962,89153,-1.34
2024-08-31,D031,3958,51130,55088,56675,-2.8
2024-09-06,D031,4939,92578,97517,99254,-1.75
2024-09-06,D031,6730,85257,91987,93356,-1.47
2024-09-08,D031,5042,54598,59640,60618,-1.61
2024-09-10,D031,4185,66198,70383,68356,2.97
2024-09-15,D031,6856,63500,70356,73051,-3.69
2024-09-16,D031,3420,63840,67260,66638,0.93
2024-09-21,D031,5311,58301,63612,62626,1.57
2024-09-21,D031,6539,51225,57764,56760,1.77
2024-09-23,D031,4653,66015,70668,68680,2.89
2024-09-26,D031,5880,75709,81589,78110,4.45
2024-09-28,D031,4006,64024,68030,67809,0.33
2024-09-29,D031,5696,62012,67708,64212,5.44
2024-10-05,D031,4431,88392,92823,88362,5.05
2024-10-05,D031,4420,66720,71140,72473,-1.84
2024-10-11,D031,5665,92719,98384,94968,3.6
2024-10-15,D031,4485,94111,98596,93906,4.99
2024-10-16,D031,3849,57927,61776,60327,2.4
2024-10-19,D031,4710,89770,94480,96599,-2.19
2024-10-19,D031,4358,63107,67465,66391,1.62
2024-10-20,D031,5441,53569,59010,60768,-2.89
2024-10-24,D031,4634,66646,71280,68397,4.22
2024-11-03,D031,6516,69751,76267,73470,3.81
2024-11-08,D031,4462,60345,64807,61483,5.41
2024-11-11,D031,5810,86153,91963,88907,3.44
2024-11-13,D031,6938,60588,67526,70084,-3.65
2024-11-17,D031,3785,77881,81666,80031,2.04
2024-11-21,D031,4780,69924,74704,73007,2.32
2024-11-21,D031,3073,87621,90694,91753,-1.15
2024-11-25,D031,5034,78887,83921,86197,-2.64
2024-11-29,D031,3564,59770,63334,62585,1.2
2024-12-02,D031,5776,84364,90140,92661,-2.72
2024-12-07,D031,4442,84421,88863,89361,-0.56
2024-12-14,D031,4278,62100,66378,61509,7.92
2024-12-17,D031,6860,71009,77869,75562,3.05
2024-12-21,D031,6775,60258,67033,69602,-3.69
2024-12-22,D031,4082,53424,57506,53428,7.63
2024-12-26,D031,4548,96996,101544,104177,-2.53
2024-01-07,D032,3268,62925,66193,62575,5.78
2024-01-08,D032,4758,50868,55626,56563,-1.66
2024-01-10,D032,4110,65510,69620,67537,3.08
2024-01-11,D032,3105,67153,70258,71249,-1.39
2024-01-20,D032,5488,52785,58273,55208,5.55
2024-01-26,D032,3453,59896,63349,60907,4.01
2024-02-02,D032,4796,59711,64507,65589,-1.65
2024-02-05,D032,6953,77684,84637,84582,0.07
2024-02-06,D032,6851,86208,93059,92293,0.83
2024-02-11,D032,4320,95004,99324,97998,1.35
2024-02-12,D032,5311,55122,60433,61773,-2.17
2024-02-14,D032,6881,65668,72549,73136,-0.8
2024-02-18,D032,3463,64691,68154,64161,6.22
2024-02-24,D032,6935,98516,105451,106880,-1.34
2024-02-25,D032,3790,57440,61230,61719,-0.79
2024-03-02,D032,6877,60744,67621,66287,2.01
2024-03-10,D032,6070,62982,69052,64123,7.69
2024-03-12,D032,6139,98447,104586,106981,-2.24
2024-03-14,D032,6081,74035,80116,77541,3.32
2024-03-19,D032,3459,97164,100623,101207,-0.58
2024-03-24,D032,4137,57902,62039,60044,3.32
2024-03-24,D032,3739,77946,81685,80866,1.01
2024-03-26,D032,4039,65063,69102,67379,2.56
2024-03-27,D032,5087,83952,89039,89289,-0.28
2024-03-27,D032,5148,91991,97139,95199,2.04
2024-03-29,D032,6393,55543,61936,57696,7.35
2024-04-02,D032,5566,67665,73231,73331,-0.14
2024-04-05,D032,4495,53304,57799,57036,1.34
2024-04-07,D032,3042,68300,71342,72968,-2.23
2024-04-12,D032,5939,79841,85780,86877,-1.26
2024-04-18,D032,6556,78535,85091,80568,5.61
2024-04-27,D032,6879,95246,102125,99259,2.89
2024-04-28,D032,6445,70753,77198,76257,1.23
2024-05-03,D032,4971,62631,67602,68728,-1.64
2024-05-08,D032,3056,95301,98357,101214,-2.82
2024-05-15,D032,3759,57014,60773,60361,0.68
2024-05-16,D032,3358,79425,82783,80085,3.37
2024-05-18,D032,4299,59268,63567,62809,1.21
2024-05-20,D032,4184,88943,93127,90184,3.26
2024-05-23,D032,3015,73853,76868,73302,4.86
2024-05-24,D032,4637,64670,69307,66341,4.47
2024-06-02,D032,4593,64758,69351,68364,1.44
2024-06-08,D032,4000,54332,58332,57522,1.41
2024-06-09,D032,6327,69778,76105,78978,-3.64
2024-06-09,D032,5331,60345,65676,67548,-2.77
2024-06-23,D032,4517,70014,74531,72156,3.29
2024-06-26,D032,5586,92103,97689,93241,4.77
2024-06-26,D032,4171,86025,90196,86638,4.11
2024-06-28,D032,6253,72770,79023,80904,-2.32
2024-06-29,D032,5626,82259,87885,88040,-0.18
2024-07-01,D032,5254,86607,91861,93603,-1.86
2024-07-07,D032,4951,75855,80806,76417,5.74
2024-07-08,D032,6288,93874,100162,96933,3.33
2024-07-27,D032,6953,85954,92907,92627,0.3
2024-08-01,D032,5341,72736,78077,77663,0.53
2024-08-02,D032,5241,63601,68842,64131,7.35
2024-08-03,D032,5127,70234,75361,75834,-0.62
2024-08-07,D032,3178,92614,95792,94264,1.62
2024-08-07,D032,4846,96491,101337,97316,4.13
2024-08-09,D032,6702,99190,105892,106348,-0.43
2024-08-12,D032,6952,60585,67537,66617,1.38
2024-08-18,D032,3027,57163,60190,60720,-0.87
2024-08-21,D032,3489,91538,95027,94068,1.02
2024-08-27,D032,4986,99116,104102,100423,3.66
2024-09-06,D032,3568,63117,66685,63970,4.24
2024-09-18,D032,3349,67676,71025,72141,-1.55
2024-09-20,D032,5912,98812,104724,106224,-1.41
2024-09-22,D032,3831,76855,80686,80664,0.03
2024-09-22,D032,4481,60093,64574,61269,5.39
2024-09-23,D032,4469,54435,58904,56254,4.71
2024-10-03,D032,3531,59369,62900,59374,5.94
2024-10-06,D032,4139,79006,83145,85834,-3.13
2024-10-11,D032,5568,90385,95953,92113,4.17
2024-10-13,D032,5641,53114,58755,59829,-1.8
2024-10-14,D032,5309,58367,63676,61391,3.72
2024-10-15,D032,4967,74853,79820,76711,4.05
2024-10-25,D032,5386,76871,82257,81993,0.32
2024-10-30,D032,4321,67400,71721,67374,6.45
2024-10-31,D032,3545,71608,75153,76958,-2.35
2024-11-07,D032,5356,67158,72514,68250,6.25
2024-11-11,D032,6948,76578,83526,84835,-1.54
2024-11-12,D032,5573,84892,90465,87323,3.6
2024-11-15,D032,4417,57358,61775,60843,1.53
2024-12-02,D032,3808,91938,95746,96283,-0.56
2024-12-05,D032,4687,56833,61520,60774,1.23
2024-12-07,D032,4686,85777,90463,85657,5.61
2024-12-11,D032,5803,72942,78745,79719,-1.22
2024-12-16,D032,6983,59503,66486,66127,0.54
2024-12-16,D032,3458,98469,101927,97053,5.02
2024-12-23,D032,3761,62511,66272,67993,-2.53
2024-01-01,D033,3818,54868,58686,61674,-4.84
2024-01-01,D033,3203,96888,100091,100527,-0.43
2024-01-01,D033,4771,65284,70055,71844,-2.49
2024-01-02,D033,5272,77424,82696,79832,3.59
2024-01-05,D033,5532,80285,85817,81047,5.89
2024-01-13,D033,6879,66195,73074,72961,0.15
2024-01-16,D033,3492,63737,67229,69098,-2.7
2024-01-18,D033,5160,64586,69746,65346,6.73
2024-01-28,D033,5938,95747,101685,102385,-0.68
2024-01-28,D033,3391,75344,78735,77987,0.96
2024-01-29,D033,3625,74086,77711,80606,-3.59
2024-01-31,D033,3497,57641,61138,58614,4.31
2024-02-03,D033,5283,70942,76225,73878,3.18
2024-02-05,D033,5668,75142,80810,83107,-2.76
2024-02-07,D033,5091,97800,102891,101292,1.58
2024-02-12,D033,4882,78287,83169,85985,-3.27
2024-02-15,D033,5048,71157,76205,71793,6.15
2024-02-18,D033,3657,99852,103509,105429,-1.82
2024-02-27,D033,4116,82959,87075,84961,2.49
2024-02-27,D033,4490,97078,101568,96764,4.96
2024-03-05,D033,5193,58415,63608,61250,3.85
2024-03-06,D033,5188,53577,58765,61577,-4.57
2024-03-08,D033,6255,71033,77288,79893,-3.26
2024-03-08,D033,4196,66363,70559,69645,1.31
2024-03-11,D033,6639,98232,104871,106648,-1.67
2024-03-13,D033,6320,60750,67070,65372,2.6
2024-03-14,D033,5398,99294,104692,102630,2.01
2024-03-16,D033,3493,80383,83876,83283,0.71
2024-03-27,D033,3054,90411,93465,94642,-1.24
2024-03-27,D033,5068,58120,63188,59147,6.83
2024-03-30,D033,4830,66724,71554,70726,1.17
2024-04-09,D033,3188,59180,62368,58335,6.91
2024-04-24,D033,4919,71506,76425,71772,6.48
2024-04-25,D033,3190,60492,63682,65702,-3.07
2024-04-26,D033,6270,65167,71437,73952,-3.4
2024-04-26,D033,3240,71529,74769,72002,3.84
2024-04-27,D033,5853,73710,79563,77653,2.46
2024-04-29,D033,4560,92136,96696,98428,-1.76
2024-05-05,D033,3578,99693,103271,104110,-0.81
2024-05-06,D033,3757,76710,80467,78381,2.66
2024-05-07,D033,5598,85153,90751,90832,-0.09
2024-05-10,D033,5235,77332,82567,79973,3.24
2024-05-10,D033,4293,72443,76736,72779,5.44
2024-05-19,D033,6564,53659,60223,59621,1.01
2024-05-20,D033,4869,87879,92748,88996,4.22
2024-05-20,D033,6217,61688,67905,66496,2.12
2024-05-22,D033,3061,59457,62518,63233,-1.13
2024-05-22,D033,4260,99438,103698,100278,3.41
2024-05-25,D033,3830,51651,55481,57345,-3.25
2024-06-01,D033,5192,84016,89208,89154,0.06
2024-06-02,D033,4711,99904,104615,105146,-0.51
2024-06-09,D033,5844,89236,95080,92251,3.07
2024-06-16,D033,6913,67450,74363,69640,6.78
2024-06-17,D033,5728,73110,78838,79276,-0.55
2024-06-19,D033,4177,92225,96402,93979,2.58
2024-06-24,D033,3459,91914,95373,93808,1.67
2024-06-24,D033,3386,92454,95840,97988,-2.19
2024-06-25,D033,3284,78734,82018,79920,2.63
2024-06-27,D033,6498,88155,94653,89909,5.28
2024-07-20,D033,3935,72431,76366,75029,1.78
2024-07-23,D033,3823,86533,90356,88258,2.38
2024-07-31,D033,5876,50136,56012,57983,-3.4
2024-08-01,D033,3107,98292,101399,103427,-1.96
2024-08-08,D033,4748,53924,58672,61249,-4.21
2024-08-15,D033,3087,71513,74600,73197,1.92
2024-08-17,D033,6178,92703,98881,94325,4.83
2024-09-06,D033,4000,78410,82410,81404,1.24
2024-09-10,D033,3383,81615,84998,80032,6.21
2024-09-16,D033,6305,78506,84811,86480,-1.93
2024-09-17,D033,6561,76854,83415,79254,5.25
2024-09-25,D033,4946,67861,72807,68965,5.57
2024-10-01,D033,5708,88165,93873,93537,0.36
2024-10-02,D033,4705,96219,100924,97424,3.59
2024-10-03,D033,4871,63350,68221,64916,5.09
2024-10-03,D033,4487,71326,75813,74216,2.15
2024-10-04,D033,4649,73790,78439,79259,-1.03
2024-10-06,D033,5058,53400,58458,54279,7.7
2024-10-07,D033,4133,52599,56732,54016,5.03
2024-10-08,D033,5458,67061,72519,69610,4.18
2024-10-12,D033,6002,61595,67597,64951,4.07
2024-10-13,D033,4658,77701,82359,83396,-1.24
2024-10-21,D033,5871,50362,56233,55779,0.81
2024-10-25,D033,5462,55614,61076,56809,7.51
2024-10-28,D033,6642,95317,101959,103038,-1.05
2024-11-02,D033,5747,54677,60424,55452,8.97
2024-11-02,D033,4362,52102,56464,56434,0.05
2024-11-03,D033,6934,61409,68343,65549,4.26
2024-11-12,D033,4134,96413,100547,97577,3.04
2024-11-13,D033,3049,66402,69451,67630,2.69
2024-11-26,D033,4346,76372,80718,76039,6.15
2024-11-26,D033,4551,62625,67176,68547,-2
2024-11-28,D033,5916,79011,84927,86852,-2.22
2024-11-30,D033,5063,93563,98626,99649,-1.03
2024-12-01,D033,3598,58997,62595,57797,8.3
2024-12-17,D033,4362,50925,55287,52768,4.77
2024-12-22,D033,3175,82334,85509,81340,5.13
2024-12-27,D033,6935,51799,58734,57327,2.45
2024-12-29,D033,6678,81097,87775,83085,5.64
2024-01-01,D034,4804,90733,95537,93221,2.48
2024-01-02,D034,3361,67602,70963,73358,-3.26
2024-01-02,D034,5356,82886,88242,89700,-1.63
2024-01-04,D034,3912,67027,70939,69417,2.19
2024-01-11,D034,3521,95838,99359,100039,-0.68
2024-01-19,D034,5078,60872,65950,64831,1.73
2024-01-22,D034,5627,99336,104963,107442,-2.31
2024-01-26,D034,4233,83371,87604,84848,3.25
2024-02-07,D034,4468,74500,78968,81136,-2.67
2024-02-13,D034,6854,67485,74339,72918,1.95
2024-02-19,D034,4533,56318,60851,63550,-4.25
2024-02-24,D034,5670,52711,58381,56528,3.28
2024-02-27,D034,6325,71683,78008,80516,-3.11
2024-03-06,D034,3482,59127,62609,63314,-1.11
2024-03-08,D034,5391,81110,86501,88029,-1.74
2024-03-11,D034,5320,83978,89298,91272,-2.16
2024-03-14,D034,6890,78840,85730,85922,-0.22
2024-03-22,D034,5549,84758,90307,87711,2.96
2024-04-01,D034,5047,97277,102324,103458,-1.1
2024-04-05,D034,3988,59304,63292,59321,6.69
2024-04-11,D034,3493,51667,55160,56523,-2.41
2024-04-15,D034,3886,75003,78889,76465,3.17
2024-04-19,D034,6632,80336,86968,83240,4.48
2024-04-21,D034,4866,71196,76062,71798,5.94
2024-04-22,D034,4067,70607,74674,74751,-0.1
2024-04-24,D034,3616,70358,73974,73707,0.36
2024-05-13,D034,6462,70447,76909,74054,3.86
2024-05-16,D034,4341,64455,68796,67074,2.57
2024-05-18,D034,6867,87855,94722,95576,-0.89
2024-05-19,D034,4679,78931,83610,80762,3.53
2024-05-20,D034,6498,91789,98287,99378,-1.1
2024-05-25,D034,3232,50921,54153,50776,6.65
2024-06-05,D034,6235,82326,88561,85431,3.66
2024-06-06,D034,4763,95972,100735,97466,3.35
2024-06-09,D034,3630,64996,68626,70965,-3.3
2024-06-11,D034,4806,98223,103029,105256,-2.12
2024-06-24,D034,3787,57206,60993,59838,1.93
2024-06-27,D034,4135,72741,76876,76155,0.95
2024-06-28,D034,5856,83746,89602,92085,-2.7
2024-07-01,D034,6711,65588,72299,70887,1.99
2024-07-07,D034,3758,64211,67969,64098,6.04
2024-07-09,D034,4032,57036,61068,62228,-1.86
2024-07-12,D034,5372,54150,59522,57649,3.25
2024-07-16,D034,6569,78716,85285,83876,1.68
2024-07-20,D034,4353,76986,81339,79352,2.5
2024-07-26,D034,4288,86639,90927,92121,-1.3
2024-07-27,D034,4498,52460,56958,53138,7.19
2024-07-27,D034,5995,89097,95092,95876,-0.82
2024-08-03,D034,3775,80499,84274,80857,4.23
2024-08-13,D034,3757,96647,100404,96694,3.84
2024-08-15,D034,3584,73485,77069,77209,-0.18
2024-08-17,D034,4280,50042,54322,50937,6.65
2024-08-23,D034,4508,90972,95480,91403,4.46
2024-08-23,D034,4924,65733,70657,67957,3.97
2024-08-29,D034,3966,50889,54855,51599,6.31
2024-08-30,D034,6216,80353,86569,82321,5.16
2024-09-03,D034,3519,69596,73115,73706,-0.8
2024-09-06,D034,3559,58308,61867,56961,8.61
2024-09-07,D034,5558,79583,85141,87781,-3.01
2024-09-13,D034,5514,86737,92251,91967,0.31
2024-09-18,D034,6436,92032,98468,93783,5
2024-09-19,D034,3364,83038,86402,81761,5.68
2024-09-19,D034,4189,52340,56529,55949,1.04
2024-09-20,D034,5773,73472,79245,82167,-3.56
2024-09-21,D034,6718,72159,78877,74691,5.6
2024-09-21,D034,5837,55208,61045,63358,-3.65
2024-09-22,D034,5392,86618,92010,94321,-2.45
2024-10-06,D034,3510,75499,79009,75588,4.53
2024-10-10,D034,3898,63386,67284,69095,-2.62
2024-10-14,D034,4474,68626,73100,70825,3.21
2024-10-15,D034,3557,59808,63365,61329,3.32
2024-10-17,D034,5530,64309,69839,72606,-3.81
2024-10-21,D034,6522,52951,59473,61235,-2.88
2024-10-24,D034,6009,52589,58598,54422,7.67
2024-10-25,D034,6441,73384,79825,79313,0.65
2024-10-28,D034,4004,93459,97463,95138,2.44
2024-10-30,D034,4490,95959,100449,101163,-0.71
2024-11-05,D034,6102,76425,82527,82352,0.21
2024-11-27,D034,3169,79192,82361,79779,3.24
2024-12-01,D034,4458,77843,82301,84447,-2.54
2024-12-10,D034,6964,91004,97968,93155,5.17
2024-12-13,D034,3165,87211,90376,90480,-0.11
2024-12-21,D034,4762,73707,78469,78640,-0.22
2024-12-25,D034,4152,54959,59111,59430,-0.54
2024-01-02,D035,6872,84635,91507,89558,2.18
2024-01-03,D035,4231,71188,75419,75223,0.26
2024-01-07,D035,5202,76715,81917,81888,0.04
2024-01-22,D035,3342,57207,60549,58257,3.93
2024-01-23,D035,5349,70221,75570,78044,-3.17
2024-01-25,D035,4257,58250,62507,60137,3.94
2024-01-29,D035,3774,88964,92738,88804,4.43
2024-02-02,D035,4459,74832,79291,78162,1.44
2024-02-03,D035,5877,57139,63016,62982,0.05
2024-02-06,D035,3106,82040,85146,80238,6.12
2024-02-08,D035,6803,50306,57109,57034,0.13
2024-02-08,D035,3813,66371,70184,69060,1.63
2024-02-12,D035,3424,58484,61908,59604,3.87
2024-02-16,D035,5886,91381,97267,94668,2.75
2024-02-16,D035,4237,98621,102858,99057,3.84
2024-02-17,D035,6089,61151,67240,64682,3.95
2024-02-17,D035,3398,85398,88796,89350,-0.62
2024-02-17,D035,5271,88914,94185,96814,-2.72
2024-02-25,D035,5667,95528,101195,100828,0.36
2024-02-29,D035,3005,63269,66274,62561,5.94
2024-03-01,D035,4461,67671,72132,72288,-0.22
2024-03-02,D035,5333,63276,68609,68004,0.89
2024-03-03,D035,5291,99688,104979,106354,-1.29
2024-03-09,D035,4411,56544,60955,63318,-3.73
2024-03-15,D035,3977,59318,63295,65999,-4.1
2024-03-19,D035,4540,69259,73799,73608,0.26
2024-03-21,D035,4005,81913,85918,86570,-0.75
2024-03-28,D035,6680,93663,100343,96168,4.34
2024-04-02,D035,4065,74016,78081,74559,4.72
2024-04-07,D035,6739,97617,104356,104959,-0.57
2024-04-10,D035,3660,96737,100397,96286,4.27
2024-04-14,D035,6858,61201,68059,70533,-3.51
2024-04-20,D035,5661,84832,90493,89642,0.95
2024-04-20,D035,5913,76762,82675,80584,2.59
2024-04-21,D035,6869,68467,75336,76296,-1.26
2024-04-25,D035,5652,60618,66270,65477,1.21
2024-04-28,D035,3576,72842,76418,78665,-2.86
2024-04-28,D035,5372,93908,99280,98981,0.3
2024-05-05,D035,5442,61120,66562,67733,-1.73
2024-05-05,D035,5900,66212,72112,73876,-2.39
2024-05-13,D035,3707,67361,71068,70607,0.65
2024-05-20,D035,5893,69439,75332,76702,-1.79
2024-05-26,D035,4555,94472,99027,94458,4.84
2024-05-26,D035,4565,56142,60707,59790,1.53
2024-05-30,D035,5997,67070,73067,69757,4.75
2024-06-01,D035,4884,52961,57845,54830,5.5
2024-06-02,D035,4828,57909,62737,60149,4.3
2024-06-07,D035,6483,85712,92195,90819,1.52
2024-06-16,D035,5639,95349,100988,100072,0.92
2024-06-25,D035,4122,70463,74585,76014,-1.88
2024-06-28,D035,3638,83823,87461,83541,4.69
2024-07-01,D035,5317,55586,60903,60986,-0.14
2024-07-02,D035,4309,70536,74845,69944,7.01
2024-07-04,D035,4976,98328,103304,102331,0.95
2024-07-05,D035,4062,74248,78310,76108,2.89
2024-07-10,D035,5290,84622,89912,90304,-0.43
2024-07-10,D035,6120,90447,96567,99551,-3
2024-07-11,D035,6374,83593,89967,91963,-2.17
2024-07-15,D035,5529,50877,56406,52013,8.45
2024-07-16,D035,3759,60349,64108,65757,-2.51
2024-07-16,D035,5532,78404,83936,81758,2.66
2024-07-20,D035,5514,71604,77118,72368,6.56
2024-07-25,D035,5716,99730,105446,103964,1.43
2024-07-25,D035,6995,64306,71301,67639,5.41
2024-07-26,D035,5055,89613,94668,93910,0.81
2024-07-31,D035,6236,69282,75518,70972,6.41
2024-08-13,D035,3307,53546,56853,55876,1.75
2024-08-13,D035,5277,58183,63460,62183,2.05
2024-08-15,D035,6291,85256,91547,91847,-0.33
2024-08-17,D035,5178,60871,66049,61439,7.5
2024-08-23,D035,4013,78799,82812,83262,-0.54
2024-08-24,D035,4875,80519,85394,82586,3.4
2024-08-31,D035,6578,79038,85616,85274,0.4
2024-09-12,D035,3698,57243,60941,58645,3.92
2024-09-19,D035,6668,78482,85150,86573,-1.64
2024-09-23,D035,6647,79165,85812,87227,-1.62
2024-09-29,D035,3475,95138,98613,96384,2.31
2024-10-01,D035,3186,74563,77749,78459,-0.9
2024-10-12,D035,3347,83040,86387,86377,0.01
2024-10-20,D035,3599,61530,65129,62009,5.03
2024-10-25,D035,4378,65563,69941,71629,-2.36
2024-10-27,D035,5475,65442,70917,69057,2.69
2024-10-29,D035,4519,72161,76680,71745,6.88
2024-11-01,D035,5919,94885,100804,102325,-1.49
2024-11-15,D035,6056,91752,97808,100017,-2.21
2024-11-19,D035,5219,97972,103191,104127,-0.9
2024-11-20,D035,3521,73016,76537,73489,4.15
2024-11-20,D035,5353,76379,81732,82481,-0.91
2024-11-20,D035,3893,94898,98791,99505,-0.72
2024-11-25,D035,4057,92915,96972,95295,1.76
2024-11-27,D035,6677,80980,87657,88640,-1.11
2024-11-28,D035,6251,55534,61785,62892,-1.76
2024-12-03,D035,4972,62178,67150,67906,-1.11
2024-12-06,D035,4212,85230,89442,86984,2.83
2024-12-06,D035,5499,94400,99899,97860,2.08
2024-12-12,D035,6560,74805,81365,81948,-0.71
2024-12-15,D035,5123,62834,67957,68643,-1
2024-12-17,D035,3185,84319,87504,85112,2.81
2024-12-21,D035,3138,59718,62856,61959,1.45
2024-01-02,D036,5942,87224,93166,93845,-0.72
2024-01-06,D036,6991,67297,74288,70930,4.73
2024-01-07,D036,6613,81186,87799,88447,-0.73
2024-01-09,D036,4198,68676,72874,71657,1.7
2024-01-12,D036,4260,84625,88885,91116,-2.45
2024-01-13,D036,5886,59260,65146,62706,3.89
2024-01-13,D036,3271,92741,96012,92736,3.53
2024-01-16,D036,4549,65128,69677,70781,-1.56
2024-01-16,D036,4041,66519,70560,71535,-1.36
2024-01-18,D036,6161,50692,56853,55503,2.43
2024-01-19,D036,4552,81556,86108,84590,1.79
2024-01-29,D036,4979,71305,76284,78469,-2.78
2024-01-30,D036,3044,84578,87622,86056,1.82
2024-01-31,D036,5945,65887,71832,70088,2.49
2024-02-01,D036,5911,83919,89830,85211,5.42
2024-02-05,D036,6317,84814,91131,90987,0.16
2024-02-07,D036,3356,90253,93609,90857,3.03
2024-02-08,D036,5100,76841,81941,81152,0.97
2024-02-10,D036,4507,72787,77294,73710,4.86
2024-02-15,D036,4466,57749,62215,60472,2.88
2024-02-16,D036,4066,53392,57458,55545,3.44
2024-02-18,D036,3303,84930,88233,84747,4.11
2024-02-19,D036,6943,73939,80882,80809,0.09
2024-02-21,D036,4744,65154,69898,65088,7.39
2024-02-24,D036,5597,78914,84511,80143,5.45
2024-02-25,D036,5670,63017,68687,71448,-3.86
2024-02-28,D036,5555,68689,74244,72736,2.07
2024-02-29,D036,6238,86041,92279,88279,4.53
2024-03-06,D036,5382,76017,81399,81420,-0.03
2024-03-10,D036,6301,65839,72140,70512,2.31
2024-03-10,D036,6323,69870,76193,77383,-1.54
2024-03-13,D036,6308,52093,58401,56688,3.02
2024-03-15,D036,3350,64530,67880,63526,6.85
2024-03-18,D036,5831,94370,100201,100480,-0.28
2024-03-21,D036,5536,79566,85102,82895,2.66
2024-03-25,D036,6143,56710,62853,60853,3.29
2024-03-27,D036,5450,66779,72229,71631,0.83
2024-03-31,D036,5437,62194,67631,63105,7.17
2024-04-06,D036,3749,71676,75425,78125,-3.46
2024-04-08,D036,6500,74950,81450,82330,-1.07
2024-04-10,D036,6010,99724,105734,107402,-1.55
2024-04-11,D036,4610,78064,82674,80339,2.91
2024-04-17,D036,4184,53199,57383,58638,-2.14
2024-04-18,D036,4878,92156,97034,98262,-1.25
2024-04-21,D036,3717,50642,54359,53919,0.82
2024-04-23,D036,4772,59470,64242,66777,-3.8
2024-04-25,D036,4881,70553,75434,74571,1.16
2024-05-02,D036,4708,74911,79619,81443,-2.24
2024-05-03,D036,6340,99948,106288,107331,-0.97
2024-05-11,D036,4347,67241,71588,69337,3.25
2024-05-14,D036,5029,51924,56953,56858,0.17
2024-05-14,D036,6299,70936,77235,78028,-1.02
2024-05-18,D036,3435,95454,98889,96559,2.41
2024-05-21,D036,3721,80279,84000,81145,3.52
2024-05-23,D036,4358,79870,84228,85351,-1.32
2024-05-26,D036,3121,99232,102353,102621,-0.26
2024-05-26,D036,5950,54761,60711,56081,8.26
2024-05-27,D036,5045,77624,82669,84281,-1.91
2024-06-02,D036,6593,58606,65199,64775,0.65
2024-06-10,D036,4736,96313,101049,100438,0.61
2024-06-11,D036,6999,95487,102486,103395,-0.88
2024-06-12,D036,5115,93299,98414,98675,-0.26
2024-06-13,D036,5024,66766,71790,72534,-1.03
2024-06-13,D036,3732,91540,95272,97452,-2.24
2024-06-15,D036,6361,72967,79328,74493,6.49
2024-06-21,D036,3019,52368,55387,54540,1.55
2024-06-24,D036,5902,63421,69323,65496,5.84
2024-07-02,D036,4642,52643,57285,57988,-1.21
2024-07-06,D036,6653,55583,62236,60339,3.14
2024-07-10,D036,4946,97605,102551,98449,4.17
2024-07-13,D036,6263,98707,104970,104145,0.79
2024-07-21,D036,3050,94814,97864,96445,1.47
2024-07-27,D036,4956,89339,94295,96903,-2.69
2024-08-01,D036,4945,97750,102695,100632,2.05
2024-08-07,D036,4707,91147,95854,97640,-1.83
2024-08-19,D036,4764,95408,100172,95329,5.08
2024-08-20,D036,6799,88869,95668,94076,1.69
2024-08-26,D036,6219,98594,104813,106051,-1.17
2024-08-26,D036,6240,76564,82804,79776,3.8
2024-08-29,D036,6395,97295,103690,105650,-1.86
2024-09-10,D036,3670,86126,89796,86142,4.24
2024-09-14,D036,6789,76588,83377,84830,-1.71
2024-09-14,D036,3569,77463,81032,77972,3.92
2024-09-20,D036,3976,67118,71094,71626,-0.74
2024-09-21,D036,6183,62026,68209,63366,7.64
2024-09-21,D036,4461,90695,95156,94838,0.34
2024-09-24,D036,4098,84818,88916,90318,-1.55
2024-09-26,D036,6934,61534,68468,66917,2.32
2024-09-29,D036,6991,53129,60120,57673,4.24
2024-10-03,D036,4960,74437,79397,75438,5.25
2024-10-04,D036,6089,83291,89380,88105,1.45
2024-10-08,D036,3028,74063,77091,73272,5.21
2024-10-11,D036,5747,58705,64452,65532,-1.65
2024-10-12,D036,3264,56816,60080,59633,0.75
2024-10-14,D036,3225,79759,82984,80922,2.55
2024-10-14,D036,4051,69643,73694,70495,4.54
2024-10-18,D036,3793,84884,88677,85898,3.24
2024-10-24,D036,4314,63562,67876,67764,0.17
2024-10-26,D036,4638,51582,56220,53038,6
2024-11-15,D036,6568,79281,85849,84738,1.31
2024-11-16,D036,4869,61464,66333,67064,-1.09
2024-11-19,D036,6204,88727,94931,97805,-2.94
2024-11-20,D036,3578,52808,56386,52044,8.34
2024-11-21,D036,5856,63493,69349,71664,-3.23
2024-11-21,D036,6069,85604,91673,89746,2.15
2024-12-02,D036,3148,83837,86985,84722,2.67
2024-12-06,D036,5757,77200,82957,80962,2.46
2024-12-10,D036,5396,91098,96494,94571,2.03
2024-12-10,D036,5711,95712,101423,98150,3.33
2024-12-11,D036,4986,80206,85192,88046,-3.24
2024-12-25,D036,6569,96322,102891,100580,2.3
2024-12-30,D036,5263,90631,95894,92736,3.41
2024-12-30,D036,3275,72064,75339,71588,5.24
2024-01-06,D037,3852,87170,91022,91427,-0.44
2024-01-06,D037,5739,98447,104186,105425,-1.18
2024-01-07,D037,6267,89332,95599,97008,-1.45
2024-01-11,D037,4562,61101,65663,63461,3.47
2024-01-13,D037,4725,69418,74143,74756,-0.82
2024-01-15,D037,6414,56861,63275,60181,5.14
2024-01-25,D037,4391,77445,81836,80486,1.68
2024-01-27,D037,6382,74860,81242,78463,3.54
2024-02-03,D037,3595,79592,83187,78312,6.23
2024-02-06,D037,6690,68227,74917,77733,-3.62
2024-02-18,D037,4090,93794,97884,96660,1.27
2024-02-25,D037,5379,81555,86934,88160,-1.39
2024-03-01,D037,4627,89709,94336,94834,-0.53
2024-03-02,D037,4085,75208,79293,77406,2.44
2024-03-03,D037,6923,74843,81766,79242,3.19
2024-03-04,D037,5778,98469,104247,104189,0.06
2024-03-07,D037,6122,74160,80282,79607,0.85
2024-03-08,D037,3049,89575,92624,88950,4.13
2024-03-13,D037,3559,96097,99656,96035,3.77
2024-03-14,D037,6579,74648,81227,77776,4.44
2024-03-16,D037,6235,52419,58654,53914,8.79
2024-03-17,D037,4620,58080,62700,62582,0.19
2024-03-22,D037,6727,70619,77346,79806,-3.08
2024-03-23,D037,4716,88551,93267,92116,1.25
2024-03-26,D037,6645,60559,67204,64684,3.9
2024-03-27,D037,5700,73199,78899,78270,0.8
2024-03-29,D037,6639,61357,67996,63736,6.68
2024-04-03,D037,4396,76962,81358,80850,0.63
2024-04-05,D037,5154,67015,72169,71485,0.96
2024-04-06,D037,4640,98151,102791,100984,1.79
2024-04-06,D037,4688,69369,74057,74981,-1.23
2024-04-12,D037,3535,59583,63118,64883,-2.72
2024-04-14,D037,4497,50395,54892,54375,0.95
2024-04-14,D037,3577,53514,57091,58293,-2.06
2024-04-17,D037,3171,59650,62821,62272,0.88
2024-04-22,D037,5999,77728,83727,86029,-2.68
2024-04-24,D037,5267,58123,63390,66360,-4.48
2024-04-26,D037,4853,51150,56003,51443,8.86
2024-05-07,D037,3556,65577,69133,64219,7.65
2024-05-11,D037,5403,87941,93344,95455,-2.21
2024-05-13,D037,3320,93397,96717,99284,-2.59
2024-05-21,D037,5760,56089,61849,61459,0.63
2024-05-24,D037,6815,91831,98646,99673,-1.03
2024-05-24,D037,6163,91041,97204,99468,-2.28
2024-05-26,D037,4774,60651,65425,67490,-3.06
2024-05-31,D037,6179,65136,71315,71352,-0.05
2024-05-31,D037,6846,62359,69205,71981,-3.86
2024-06-06,D037,6885,69420,76305,78645,-2.98
2024-06-07,D037,4883,50797,55680,58663,-5.08
2024-06-09,D037,3426,52196,55622,55723,-0.18
2024-06-10,D037,5248,98581,103829,104380,-0.53
2024-06-12,D037,4909,60238,65147,61940,5.18
2024-06-18,D037,3123,58036,61159,56957,7.38
2024-06-19,D037,5983,81705,87688,86410,1.48
2024-06-20,D037,6060,52044,58104,53736,8.13
2024-06-21,D037,6791,81663,88454,84263,4.97
2024-07-04,D037,5743,58117,63860,60502,5.55
2024-07-07,D037,3871,62582,66453,66199,0.38
2024-07-07,D037,4376,58706,63082,65380,-3.51
2024-07-13,D037,4390,98407,102797,102443,0.35
2024-07-13,D037,5339,66246,71585,70229,1.93
2024-07-16,D037,3806,90970,94776,92595,2.36
2024-07-16,D037,5860,76849,82709,82719,-0.01
2024-08-08,D037,6935,71947,78882,78694,0.24
2024-08-09,D037,6186,55789,61975,60621,2.23
2024-08-09,D037,4993,54318,59311,55375,7.11
2024-08-13,D037,6078,52983,59061,54802,7.77
2024-08-17,D037,4857,73989,78846,74141,6.35
2024-08-24,D037,3899,69861,73760,75016,-1.67
2024-08-27,D037,5184,87630,92814,94827,-2.12
2024-08-30,D037,3478,60889,64367,61657,4.4
2024-09-02,D037,5676,51627,57303,56831,0.83
2024-09-08,D037,6083,74976,81059,78124,3.76
2024-09-09,D037,4787,89051,93838,89828,4.46
2024-09-12,D037,5354,96762,102116,98596,3.57
2024-09-14,D037,5686,87860,93546,90524,3.34
2024-09-18,D037,5291,85289,90580,87055,4.05
2024-09-20,D037,6124,53051,59175,54388,8.8
2024-09-28,D037,4828,74215,79043,75106,5.24
2024-10-02,D037,4175,57331,61506,61145,0.59
2024-10-04,D037,4977,94331,99308,96387,3.03
2024-10-08,D037,6157,94254,100411,97954,2.51
2024-10-11,D037,3194,53982,57176,55853,2.37
2024-10-15,D037,4277,52243,56520,56875,-0.62
2024-10-17,D037,4715,58150,62865,63950,-1.7
2024-10-31,D037,5111,91249,96360,97295,-0.96
2024-11-02,D037,3270,92503,95773,98224,-2.5
2024-11-08,D037,6201,88239,94440,96552,-2.19
2024-11-17,D037,3974,70545,74519,71557,4.14
2024-11-23,D037,5566,99079,104645,107271,-2.45
2024-11-24,D037,5832,77534,83366,80327,3.78
2024-12-06,D037,5874,53312,59186,57313,3.27
2024-12-06,D037,6981,87441,94422,95300,-0.92
2024-12-10,D037,4315,63136,67451,64476,4.61
2024-12-28,D037,5429,50973,56402,55378,1.85
2024-01-08,D038,4241,84510,88751,86042,3.15
2024-01-10,D038,4700,81739,86439,81791,5.68
2024-01-12,D038,5263,76188,81451,80636,1.01
2024-01-17,D038,4173,99490,103663,105595,-1.83
2024-01-21,D038,6891,65522,72413,68268,6.07
2024-01-28,D038,6995,86468,93463,94947,-1.56
2024-02-10,D038,5952,75587,81539,81075,0.57
2024-02-10,D038,5365,80523,85888,84412,1.75
2024-02-14,D038,3953,83616,87569,85577,2.33
2024-02-21,D038,5775,66455,72230,75203,-3.95
2024-02-24,D038,4330,61109,65439,66993,-2.32
2024-03-02,D038,4286,58303,62589,58681,6.66
2024-03-03,D038,4564,55906,60470,59540,1.56
2024-03-10,D038,6187,72766,78953,78547,0.52
2024-03-16,D038,4622,98756,103378,106037,-2.51
2024-03-17,D038,6420,61410,67830,67692,0.2
2024-03-19,D038,5708,73177,78885,74247,6.25
2024-03-22,D038,4452,84594,89046,88817,0.26
2024-03-27,D038,4204,63336,67540,67081,0.68
2024-03-30,D038,4721,78477,83198,81745,1.78
2024-04-03,D038,4118,90752,94870,96266,-1.45
2024-04-05,D038,5442,65256,70698,68793,2.77
2024-04-09,D038,6776,94433,101209,98899,2.34
2024-04-15,D038,3506,80254,83760,79412,5.48
2024-04-17,D038,4240,65619,69859,67940,2.82
2024-04-23,D038,6504,67375,73879,69356,6.52
2024-04-28,D038,3292,82323,85615,84818,0.94
2024-05-01,D038,4053,86027,90080,89645,0.49
2024-05-06,D038,4749,68756,73505,68530,7.26
2024-05-07,D038,5663,55004,60667,57346,5.79
2024-05-07,D038,4260,86845,91105,89207,2.13
2024-05-13,D038,3812,81876,85688,85305,0.45
2024-05-13,D038,6982,94846,101828,100816,1
2024-05-14,D038,6917,95802,102719,103235,-0.5
2024-05-18,D038,3194,84318,87512,88720,-1.36
2024-05-19,D038,6274,67903,74177,69254,7.11
2024-05-21,D038,5659,70980,76639,78800,-2.74
2024-05-27,D038,5033,59752,64785,64328,0.71
2024-06-02,D038,4413,50619,55032,57150,-3.71
2024-06-04,D038,4220,79506,83726,81755,2.41
2024-06-06,D038,6320,79665,85985,84812,1.38
2024-06-16,D038,6066,76844,82910,78847,5.15
2024-06-16,D038,4985,95682,100667,101636,-0.95
2024-06-17,D038,6174,72369,78543,80661,-2.63
2024-06-17,D038,4891,83092,87983,84015,4.72
2024-06-24,D038,5569,92732,98301,95725,2.69
2024-06-28,D038,3427,74255,77682,80286,-3.24
2024-06-28,D038,4431,68268,72699,74181,-2
2024-07-06,D038,5054,98874,103928,106372,-2.3
2024-07-06,D038,5389,69937,75326,73188,2.92
2024-07-07,D038,3080,84923,88003,89659,-1.85
2024-07-09,D038,4445,66436,70881,72124,-1.72
2024-07-09,D038,6246,62288,68534,65516,4.61
2024-07-10,D038,3498,54917,58415,55584,5.09
2024-07-14,D038,3886,61725,65611,64675,1.45
2024-07-14,D038,4226,74660,78886,75935,3.89
2024-07-15,D038,6741,99355,106096,102757,3.25
2024-07-24,D038,6216,72072,78288,77622,0.86
2024-07-25,D038,4133,73991,78124,79823,-2.13
2024-07-28,D038,3035,99242,102277,101905,0.37
2024-07-29,D038,4095,96057,100152,96134,4.18
2024-08-03,D038,6509,59915,66424,67832,-2.08
2024-08-08,D038,3499,80394,83893,79683,5.28
2024-08-10,D038,4594,58438,63032,62321,1.14
2024-08-13,D038,5062,69167,74229,73585,0.88
2024-08-13,D038,5556,66163,71719,70143,2.25
2024-08-14,D038,4906,85854,90760,88449,2.61
2024-08-15,D038,4225,94852,99077,94144,5.24
2024-08-18,D038,6761,65422,72183,73675,-2.03
2024-08-26,D038,5523,95311,100834,98565,2.3
2024-08-29,D038,3120,51637,54757,50552,8.32
2024-09-03,D038,6058,71404,77462,72539,6.79
2024-09-05,D038,4269,67323,71592,72982,-1.9
2024-09-09,D038,3965,98373,102338,100504,1.82
2024-09-15,D038,3098,55458,58556,60746,-3.61
2024-09-20,D038,5992,95975,101967,104807,-2.71
2024-09-21,D038,4481,76835,81316,81167,0.18
2024-09-22,D038,4447,69583,74030,70649,4.79
2024-10-06,D038,6908,90545,97453,100256,-2.8
2024-10-06,D038,3636,53775,57411,57990,-1
2024-10-09,D038,5964,58104,64068,65758,-2.57
2024-10-10,D038,6864,54873,61737,64294,-3.98
2024-10-17,D038,5944,97101,103045,99790,3.26
2024-10-23,D038,6497,59864,66361,62427,6.3
2024-10-26,D038,5226,50891,56117,53529,4.83
2024-10-27,D038,5941,68866,74807,70214,6.54
2024-11-06,D038,3067,74014,77081,79994,-3.64
2024-11-09,D038,5653,83064,88717,90088,-1.52
2024-11-15,D038,6158,86358,92516,88071,5.05
2024-11-16,D038,4054,98515,102569,99825,2.75
2024-11-23,D038,6136,98821,104957,107717,-2.56
2024-12-03,D038,6884,86734,93618,94741,-1.19
2024-12-09,D038,6966,65735,72701,68063,6.81
2024-12-15,D038,5343,72785,78128,75928,2.9
2024-12-18,D038,4046,87438,91484,92294,-0.88
2024-12-19,D038,4946,71587,76533,79342,-3.54
2024-12-19,D038,5571,76212,81783,81668,0.14
2024-12-22,D038,4411,84433,88844,87225,1.86
2024-12-25,D038,4678,81633,86311,89132,-3.16
2024-12-26,D038,6918,94655,101573,97737,3.92
2024-12-27,D038,4745,81673,86418,83020,4.09
2024-12-28,D038,4644,59524,64168,59949,7.04
2024-01-02,D039,3754,94328,98082,98824,-0.75
2024-01-07,D039,5687,71498,77185,75523,2.2
2024-01-08,D039,4392,89255,93647,90771,3.17
2024-01-12,D039,4358,75614,79972,82945,-3.58
2024-01-13,D039,4832,93700,98532,101040,-2.48
2024-01-13,D039,5896,85871,91767,92327,-0.61
2024-01-20,D039,4484,67600,72084,72793,-0.97
2024-01-23,D039,6631,66679,73310,74257,-1.28
2024-02-05,D039,5471,62716,68187,67728,0.68
2024-02-06,D039,4677,90484,95161,92522,2.85
2024-02-11,D039,4947,84076,89023,89037,-0.02
2024-02-15,D039,5971,94525,100496,99920,0.58
2024-02-25,D039,4342,98503,102845,102214,0.62
2024-03-02,D039,4277,73949,78226,73302,6.72
2024-03-03,D039,3686,75881,79567,77007,3.32
2024-03-03,D039,6631,50303,56934,54754,3.98
2024-03-05,D039,6084,72740,78824,79815,-1.24
2024-03-08,D039,6260,78491,84751,79863,6.12
2024-03-12,D039,5290,68961,74251,73591,0.9
2024-03-14,D039,5467,50472,55939,57152,-2.12
2024-03-18,D039,5999,91034,97033,99739,-2.71
2024-03-30,D039,3263,71711,74974,71107,5.44
2024-03-30,D039,4709,60361,65070,63832,1.94
2024-03-30,D039,5764,80663,86427,83349,3.69
2024-03-30,D039,5393,58384,63777,61242,4.14
2024-03-31,D039,6929,69149,76078,71894,5.82
2024-04-03,D039,5476,53340,58816,53940,9.04
2024-04-09,D039,5034,66249,71283,70472,1.15
2024-04-09,D039,4312,87220,91532,92462,-1.01
2024-04-13,D039,6597,89711,96308,95546,0.8
2024-04-18,D039,6764,71545,78309,76004,3.03
2024-04-20,D039,4479,94345,98824,98506,0.32
2024-04-23,D039,6843,77140,83983,80772,3.98
2024-04-27,D039,3404,98807,102211,98071,4.22
2024-05-01,D039,3466,87194,90660,88082,2.93
2024-05-03,D039,4780,76107,80887,81973,-1.32
2024-05-04,D039,6384,89887,96271,95205,1.12
2024-05-05,D039,5360,86432,91792,91303,0.54
2024-05-07,D039,3855,98409,102264,99104,3.19
2024-05-13,D039,3625,65858,69483,68249,1.81
2024-05-14,D039,6693,59796,66489,63210,5.19
2024-05-18,D039,5125,73412,78537,75058,4.64
2024-05-18,D039,4315,51587,55902,57080,-2.06
2024-05-26,D039,6445,68095,74540,76866,-3.03
2024-06-01,D039,3591,61170,64761,62497,3.62
2024-06-03,D039,4198,89759,93957,96843,-2.98
2024-06-04,D039,4181,87412,91593,87819,4.3
2024-06-14,D039,4949,99849,104798,107767,-2.76
2024-06-17,D039,4172,52808,56980,55117,3.38
2024-06-20,D039,3273,68690,71963,73805,-2.5
2024-06-25,D039,5137,61811,66948,68754,-2.63
2024-07-01,D039,6112,72054,78166,76674,1.95
2024-07-08,D039,4894,52523,57417,56835,1.02
2024-07-10,D039,3763,89649,93412,89463,4.41
2024-07-14,D039,3186,97448,100634,97267,3.46
2024-07-16,D039,4669,77202,81871,78337,4.51
2024-07-22,D039,4135,94289,98424,100475,-2.04
2024-07-24,D039,6357,69560,75917,78164,-2.87
2024-07-29,D039,5037,97268,102305,102109,0.19
2024-08-02,D039,4215,51695,55910,57003,-1.92
2024-08-07,D039,4129,78022,82151,83546,-1.67
2024-08-09,D039,3826,96407,100233,96911,3.43
2024-08-10,D039,6255,56638,62893,59323,6.02
2024-08-10,D039,3633,59348,62981,58651,7.38
2024-08-11,D039,4548,59882,64430,66294,-2.81
2024-08-15,D039,6745,50794,57539,54133,6.29
2024-08-19,D039,3958,98322,102280,105216,-2.79
2024-08-20,D039,5170,93881,99051,96996,2.12
2024-08-23,D039,5307,71705,77012,76167,1.11
2024-08-28,D039,3563,95151,98714,95695,3.15
2024-08-28,D039,5506,94311,99817,98022,1.83
2024-09-01,D039,3756,91783,95539,95712,-0.18
2024-09-05,D039,3637,74474,78111,80162,-2.56
2024-09-15,D039,6787,84864,91651,91042,0.67
2024-09-16,D039,5941,57170,63111,61000,3.46
2024-09-18,D039,3579,81922,85501,86097,-0.69
2024-09-21,D039,4250,54758,59008,57645,2.36
2024-09-21,D039,6731,89095,95826,96552,-0.75
2024-09-28,D039,5046,88735,93781,92191,1.72
2024-09-29,D039,4254,56229,60483,55842,8.31
2024-09-30,D039,4189,59589,63778,60262,5.83
2024-09-30,D039,5435,58792,64227,64864,-0.98
2024-10-01,D039,6982,82799,89781,92605,-3.05
2024-10-03,D039,5653,51454,57107,58969,-3.16
2024-10-06,D039,5940,71793,77733,76663,1.4
2024-10-06,D039,3071,77144,80215,79778,0.55
2024-10-15,D039,6514,96097,102611,102832,-0.21
2024-10-17,D039,5866,84862,90728,87549,3.63
2024-10-21,D039,4009,79312,83321,83482,-0.19
2024-10-22,D039,5770,64620,70390,69787,0.86
2024-10-29,D039,3540,82844,86384,86317,0.08
2024-10-30,D039,3578,54316,57894,53772,7.67
2024-11-01,D039,3505,71624,75129,70828,6.07
2024-11-03,D039,5138,61656,66794,62093,7.57
2024-11-03,D039,6292,91779,98071,100652,-2.56
2024-11-07,D039,6431,72912,79343,78192,1.47
2024-11-11,D039,6885,72276,79161,78465,0.89
2024-11-11,D039,4425,70704,75129,73817,1.78
2024-11-21,D039,3705,96581,100286,102122,-1.8
2024-11-22,D039,6454,57572,64026,66002,-2.99
2024-11-28,D039,3396,85111,88507,91401,-3.17
2024-12-12,D039,3812,85755,89567,86982,2.97
2024-12-14,D039,4294,94732,99026,98934,0.09
2024-12-17,D039,3938,79610,83548,82247,1.58
2024-12-20,D039,4787,79516,84303,79929,5.47
2024-12-22,D039,6375,79928,86303,81809,5.49
2024-12-27,D039,5621,70719,76340,79251,-3.67
2024-12-29,D039,6856,62661,69517,65118,6.76
2024-01-06,D040,4343,60161,64504,60307,6.96
2024-01-10,D040,6282,58002,64284,63037,1.98
2024-01-12,D040,3140,78202,81342,84326,-3.54
2024-01-16,D040,4631,88180,92811,88498,4.87
2024-01-22,D040,6951,71468,78419,78922,-0.64
2024-01-23,D040,6336,71281,77617,75580,2.7
2024-01-25,D040,6332,65585,71917,73934,-2.73
2024-02-07,D040,4071,52768,56839,54537,4.22
2024-02-16,D040,3974,59930,63904,63619,0.45
2024-02-18,D040,3326,59984,63310,64551,-1.92
2024-02-23,D040,6969,79873,86842,85962,1.02
2024-02-23,D040,4282,55558,59840,61706,-3.02
2024-03-03,D040,5689,98894,104583,107121,-2.37
2024-03-07,D040,3949,62693,66642,68593,-2.84
2024-03-15,D040,5607,97775,103382,104341,-0.92
2024-03-18,D040,5873,76400,82273,83980,-2.03
2024-03-25,D040,3449,91605,95054,91291,4.12
2024-04-05,D040,3456,59417,62873,64638,-2.73
2024-04-08,D040,5272,91811,97083,95547,1.61
2024-04-15,D040,3282,98231,101513,100057,1.46
2024-04-18,D040,3073,89489,92562,94883,-2.45
2024-04-19,D040,3191,75479,78670,76458,2.89
2024-04-23,D040,6323,88506,94829,92161,2.89
2024-04-30,D040,3294,67527,70821,73366,-3.47
2024-05-09,D040,4619,58512,63131,64789,-2.56
2024-05-10,D040,3578,68594,72172,74134,-2.65
2024-05-22,D040,3204,73168,76372,75543,1.1
2024-05-24,D040,5422,62449,67871,62958,7.8
2024-05-27,D040,6289,78378,84667,80543,5.12
2024-05-28,D040,6502,59524,66026,61722,6.97
2024-06-04,D040,5468,76728,82196,83468,-1.52
2024-06-09,D040,5911,65174,71085,73555,-3.36
2024-06-09,D040,6744,81781,88525,88060,0.53
2024-06-12,D040,3300,86142,89442,86012,3.99
2024-06-21,D040,4358,53283,57641,55950,3.02
2024-06-24,D040,6500,51910,58410,60678,-3.74
2024-06-25,D040,3020,87179,90199,90588,-0.43
2024-07-01,D040,4688,54583,59271,56325,5.23
2024-07-02,D040,5042,54891,59933,57941,3.44
2024-07-02,D040,5551,76543,82094,81206,1.09
2024-07-02,D040,4283,69230,73513,70727,3.94
2024-07-07,D040,6235,97068,103303,102696,0.59
2024-07-10,D040,6105,66047,72152,67568,6.78
2024-07-10,D040,6760,67787,74547,75557,-1.34
2024-07-11,D040,5286,79737,85023,83194,2.2
2024-07-13,D040,6340,53090,59430,55933,6.25
2024-07-13,D040,6932,75117,82049,84691,-3.12
2024-07-19,D040,3106,85194,88300,84995,3.89
2024-07-25,D040,6694,76926,83620,82413,1.46
2024-07-28,D040,3984,65328,69312,64522,7.42
2024-07-31,D040,5126,68133,73259,73584,-0.44
2024-07-31,D040,5767,74300,80067,82730,-3.22
2024-08-01,D040,5018,65090,70108,65385,7.22
2024-08-01,D040,4173,76639,80812,78602,2.81
2024-08-17,D040,3425,83892,87317,84657,3.14
2024-08-19,D040,3050,94168,97218,94941,2.4
2024-08-20,D040,3353,91964,95317,92865,2.64
2024-08-22,D040,3831,85939,89770,90579,-0.89
2024-08-24,D040,3954,60625,64579,65950,-2.08
2024-08-26,D040,6433,51505,57938,55575,4.25
2024-08-31,D040,3898,66459,70357,69031,1.92
2024-09-01,D040,4840,81912,86752,81957,5.85
2024-09-01,D040,5524,95210,100734,103478,-2.65
2024-09-05,D040,6685,74400,81085,76323,6.24
2024-09-10,D040,4211,74904,79115,79524,-0.51
2024-09-11,D040,6996,62742,69738,68539,1.75
2024-09-17,D040,4146,70710,74856,70763,5.78
2024-09-19,D040,4156,97086,101242,98313,2.98
2024-09-20,D040,6772,58711,65483,62748,4.36
2024-09-30,D040,3834,73398,77232,79531,-2.89
2024-10-03,D040,6355,91674,98029,96175,1.93
2024-10-04,D040,4772,70143,74915,75815,-1.19
2024-10-07,D040,4302,77371,81673,84231,-3.04
2024-10-14,D040,5756,63072,68828,68887,-0.09
2024-10-18,D040,6352,69403,75755,75074,0.91
2024-10-20,D040,5469,72467,77936,76066,2.46
2024-10-23,D040,6848,97111,103959,103716,0.23
2024-10-27,D040,5271,99469,104740,105344,-0.57
2024-11-01,D040,4194,57498,61692,58056,6.26
2024-11-06,D040,6702,52939,59641,55545,7.37
2024-11-11,D040,5730,69915,75645,71498,5.8
2024-11-12,D040,4986,99786,104772,105847,-1.02
2024-11-12,D040,5428,97466,102894,104821,-1.84
2024-11-20,D040,4995,97084,102079,98411,3.73
2024-12-01,D040,3639,82940,86579,83913,3.18
2024-12-08,D040,3476,72302,75778,76155,-0.5
2024-12-21,D040,5558,55079,60637,62375,-2.79
2024-12-24,D040,5452,64537,69989,70904,-1.29
2024-12-28,D040,5839,59953,65792,66801,-1.51
2024-12-30,D040,3848,52032,55880,57628,-3.03
2024-01-01,D041,6644,67587,74231,75472,-1.64
2024-01-08,D041,3066,98623,101689,100403,1.28
2024-01-12,D041,3968,99393,103361,102915,0.43
2024-01-13,D041,5257,77364,82621,85225,-3.06
2024-01-17,D041,3359,81966,85325,81316,4.93
2024-01-17,D041,3855,85634,89489,88847,0.72
2024-01-25,D041,4357,61618,65975,68860,-4.19
2024-01-27,D041,5786,83638,89424,88228,1.36
2024-01-28,D041,5182,58392,63574,60615,4.88
2024-02-03,D041,6088,72180,78268,73948,5.84
2024-02-08,D041,6342,91846,98188,98344,-0.16
2024-02-11,D041,5657,56080,61737,59075,4.51
2024-02-11,D041,5350,79092,84442,86173,-2.01
2024-02-15,D041,4017,98651,102668,99967,2.7
2024-02-16,D041,5646,71300,76946,77974,-1.32
2024-02-20,D041,5356,87921,93277,94618,-1.42
2024-02-24,D041,4908,65055,69963,65733,6.44
2024-02-28,D041,5956,77494,83450,85085,-1.92
2024-02-28,D041,5636,80635,86271,82629,4.41
2024-02-29,D041,5376,52775,58151,53515,8.66
2024-03-05,D041,4669,54758,59427,61801,-3.84
2024-03-13,D041,4164,87125,91289,92926,-1.76
2024-03-16,D041,5936,88559,94495,89865,5.15
2024-03-21,D041,5222,67629,72851,70117,3.9
2024-03-22,D041,6545,64256,70801,69999,1.15
2024-03-29,D041,3687,56924,60611,60979,-0.6
2024-04-08,D041,4682,65151,69833,70578,-1.06
2024-04-09,D041,4625,94958,99583,98700,0.89
2024-04-14,D041,4860,56158,61018,58212,4.82
2024-04-21,D041,4253,69551,73804,73807,0
2024-04-24,D041,6878,88912,95790,98238,-2.49
2024-04-27,D041,3665,91168,94833,96882,-2.11
2024-05-07,D041,4718,51778,56496,54704,3.28
2024-05-08,D041,6201,99723,105924,105293,0.6
2024-05-11,D041,3275,60737,64012,59216,8.1
2024-05-11,D041,5019,65919,70938,70619,0.45
2024-05-13,D041,4306,82408,86714,88625,-2.16
2024-05-16,D041,5928,80632,86560,81827,5.78
2024-05-16,D041,3190,80668,83858,85926,-2.41
2024-05-25,D041,5488,75462,80950,81482,-0.65
2024-05-25,D041,3270,98974,102244,104087,-1.77
2024-05-26,D041,3220,60041,63261,65399,-3.27
2024-05-30,D041,3451,93284,96735,92339,4.76
2024-06-06,D041,3568,73984,77552,75385,2.87
2024-06-09,D041,6249,79300,85549,80674,6.04
2024-06-10,D041,3806,51064,54870,56982,-3.71
2024-06-13,D041,4511,76312,80823,76971,5
2024-06-15,D041,5969,85457,91426,87236,4.8
2024-06-21,D041,5377,97322,102699,99348,3.37
2024-06-30,D041,4690,88174,92864,92624,0.26
2024-07-02,D041,6064,50329,56393,58734,-3.99
2024-07-04,D041,6937,86731,93668,91726,2.12
2024-07-05,D041,6276,80635,86911,84176,3.25
2024-07-08,D041,3686,77937,81623,79532,2.63
2024-07-10,D041,3016,53191,56207,58815,-4.43
2024-07-11,D041,3400,76732,80132,76197,5.16
2024-07-14,D041,4804,56704,61508,57537,6.9
2024-07-15,D041,3964,97830,101794,103192,-1.35
2024-07-17,D041,4215,94220,98435,97328,1.14
2024-07-20,D041,5497,84610,90107,91241,-1.24
2024-08-07,D041,3335,63864,67199,68674,-2.15
2024-08-13,D041,4680,93352,98032,93105,5.29
2024-08-14,D041,4394,76762,81156,77157,5.18
2024-08-14,D041,5843,91029,96872,94299,2.73
2024-08-15,D041,4270,77323,81593,83076,-1.79
2024-08-16,D041,6196,75409,81605,77463,5.35
2024-08-16,D041,5317,80523,85840,81899,4.81
2024-08-20,D041,6681,55362,62043,64093,-3.2
2024-08-22,D041,3626,67772,71398,70213,1.69
2024-08-25,D041,6822,51436,58258,56748,2.66
2024-09-01,D041,5566,83539,89105,88433,0.76
2024-09-06,D041,6188,81585,87773,85142,3.09
2024-09-11,D041,5523,66165,71688,73248,-2.13
2024-09-13,D041,5180,98403,103583,100688,2.88
2024-09-15,D041,4762,79048,83810,83525,0.34
2024-09-15,D041,3306,67502,70808,66715,6.14
2024-09-16,D041,6932,98552,105484,101062,4.38
2024-09-19,D041,4759,96062,100821,96283,4.71
2024-09-21,D041,4367,96628,100995,99083,1.93
2024-09-22,D041,6593,53567,60160,58812,2.29
2024-09-22,D041,6669,98127,104796,101551,3.2
2024-09-22,D041,5747,85201,90948,90647,0.33
2024-09-24,D041,5466,52282,57748,58892,-1.94
2024-09-27,D041,4643,53970,58613,58755,-0.24
2024-10-01,D041,3769,74886,78655,73837,6.53
2024-10-11,D041,4297,80958,85255,86962,-1.96
2024-10-30,D041,5220,99385,104605,106813,-2.07
2024-11-06,D041,4855,99831,104686,104434,0.24
2024-11-08,D041,6580,53832,60412,62713,-3.67
2024-11-14,D041,4242,65636,69878,72106,-3.09
2024-11-15,D041,5600,77862,83462,81272,2.69
2024-11-19,D041,6086,51515,57601,53507,7.65
2024-11-25,D041,5486,51155,56641,57751,-1.92
2024-11-29,D041,5269,82808,88077,85250,3.32
2024-11-30,D041,5865,76499,82364,77634,6.09
2024-12-13,D041,3478,63520,66998,63180,6.04
2024-12-17,D041,4859,55892,60751,62419,-2.67
2024-12-18,D041,5963,77424,83387,80076,4.13
2024-12-25,D041,5042,97427,102469,99166,3.33
2024-12-29,D041,5994,56773,62767,61951,1.32
2024-01-04,D042,6601,58498,65099,67568,-3.65
2024-01-06,D042,6102,88596,94698,93883,0.87
2024-01-06,D042,4220,52506,56726,55401,2.39
2024-01-08,D042,3968,64298,68266,65631,4.01
2024-01-12,D042,6310,83328,89638,88501,1.28
2024-01-12,D042,3832,66105,69937,70049,-0.16
2024-01-14,D042,3970,65313,69283,65126,6.38
2024-01-23,D042,4688,82828,87516,87126,0.45
2024-01-26,D042,6096,96473,102569,98919,3.69
2024-01-26,D042,6442,50055,56497,56173,0.58
2024-02-01,D042,4769,94825,99594,102570,-2.9
2024-02-02,D042,3043,83276,86319,83212,3.73
2024-02-02,D042,4993,76123,81116,76319,6.29
2024-02-11,D042,3314,65123,68437,69061,-0.9
2024-02-16,D042,3260,60456,63716,60780,4.83
2024-02-17,D042,3713,87361,91074,87082,4.58
2024-02-21,D042,5559,88076,93635,91396,2.45
2024-02-27,D042,5568,92098,97666,100457,-2.78
2024-03-09,D042,3402,63418,66820,67734,-1.35
2024-03-12,D042,5199,85993,91192,89238,2.19
2024-03-22,D042,5691,60222,65913,61511,7.16
2024-03-25,D042,3213,90056,93269,93066,0.22
2024-03-27,D042,4102,97894,101996,97492,4.62
2024-03-29,D042,5449,93303,98752,99889,-1.14
2024-03-30,D042,3313,60805,64118,64035,0.13
2024-04-01,D042,6870,94409,101279,98255,3.08
2024-04-01,D042,3316,79069,82385,79942,3.06
2024-04-02,D042,4344,58515,62859,63428,-0.9
2024-04-04,D042,4969,88653,93622,92339,1.39
2024-04-05,D042,6759,74102,80861,79598,1.59
2024-04-06,D042,5277,87234,92511,90292,2.46
2024-04-13,D042,4868,85335,90203,91205,-1.1
2024-04-30,D042,6963,52446,59409,54980,8.06
2024-05-01,D042,4673,97086,101759,101692,0.07
2024-05-02,D042,5735,96379,102114,105033,-2.78
2024-05-07,D042,6245,96105,102350,98634,3.77
2024-05-09,D042,5896,50669,56565,55094,2.67
2024-05-14,D042,4065,62963,67028,63012,6.37
2024-05-18,D042,5268,96233,101501,100414,1.08
2024-05-18,D042,6866,61159,68025,68751,-1.06
2024-05-20,D042,5755,67905,73660,70986,3.77
2024-06-20,D042,3663,84766,88429,83435,5.99
2024-06-24,D042,4090,94097,98187,94132,4.31
2024-06-24,D042,3391,50968,54359,55169,-1.47
2024-06-26,D042,3849,76685,80534,76222,5.66
2024-06-26,D042,6286,98070,104356,100898,3.43
2024-06-30,D042,5159,73531,78690,77322,1.77
2024-07-03,D042,4857,74426,79283,79624,-0.43
2024-07-04,D042,6199,59425,65624,67187,-2.33
2024-07-05,D042,5222,98861,104083,104291,-0.2
2024-07-06,D042,3975,50189,54164,50063,8.19
2024-07-11,D042,4339,58493,62832,59141,6.24
2024-07-11,D042,4356,95617,99973,96879,3.19
2024-07-17,D042,4409,80313,84722,79763,6.22
2024-07-23,D042,4848,93344,98192,99170,-0.99
2024-07-27,D042,6144,93516,99660,98175,1.51
2024-07-27,D042,5652,64429,70081,70707,-0.89
2024-07-28,D042,5863,82551,88414,88758,-0.39
2024-07-30,D042,4516,78327,82843,83757,-1.09
2024-08-03,D042,3657,84714,88371,85827,2.96
2024-08-08,D042,5370,64162,69532,72530,-4.13
2024-08-09,D042,3051,60355,63406,65869,-3.74
2024-08-15,D042,4102,71087,75189,77841,-3.41
2024-08-20,D042,5537,51756,57293,57920,-1.08
2024-08-21,D042,6714,68066,74780,73369,1.92
2024-09-02,D042,4104,71242,75346,73688,2.25
2024-09-03,D042,3537,88754,92291,93450,-1.24
2024-09-04,D042,4925,80771,85696,86634,-1.08
2024-09-05,D042,6659,81368,88027,85744,2.66
2024-09-08,D042,3871,68753,72624,71986,0.89
2024-09-08,D042,5342,96152,101494,101605,-0.11
2024-09-13,D042,4098,64679,68777,70040,-1.8
2024-09-14,D042,4729,78173,82902,84575,-1.98
2024-09-15,D042,6674,87634,94308,95361,-1.1
2024-09-16,D042,4643,87617,92260,87670,5.24
2024-09-19,D042,4319,97685,102004,100439,1.56
2024-09-30,D042,3253,64456,67709,67606,0.15
2024-10-01,D042,3272,80699,83971,80240,4.65
2024-10-02,D042,5740,85057,90797,92558,-1.9
2024-10-09,D042,5520,73506,79026,81427,-2.95
2024-10-14,D042,4190,89532,93722,91621,2.29
2024-10-21,D042,4949,69844,74793,75665,-1.15
2024-10-22,D042,4760,91804,96564,98549,-2.01
2024-10-23,D042,3970,51112,55082,55305,-0.4
2024-10-26,D042,6979,80297,87276,85824,1.69
2024-11-02,D042,4983,66075,71058,69907,1.65
2024-11-12,D042,5581,63716,69297,65316,6.09
2024-11-12,D042,5221,97573,102794,103402,-0.59
2024-11-15,D042,3181,54429,57610,56004,2.87
2024-11-15,D042,4268,50449,54717,55892,-2.1
2024-11-16,D042,6193,91277,97470,95169,2.42
2024-11-21,D042,6854,79749,86603,82457,5.03
2024-11-22,D042,3597,69446,73043,73707,-0.9
2024-11-25,D042,4702,62125,66827,64042,4.35
2024-11-25,D042,4893,54858,59751,60788,-1.71
2024-11-27,D042,6879,85904,92783,94821,-2.15
2024-11-30,D042,4232,86885,91117,93440,-2.49
2024-12-16,D042,3622,56073,59695,62335,-4.24
2024-12-19,D042,6782,58734,65516,67825,-3.4
2024-12-19,D042,6562,52520,59082,59001,0.14
2024-12-23,D042,5427,71387,76814,73013,5.21
2024-12-29,D042,3071,88314,91385,91700,-0.34
2024-12-29,D042,6183,72936,79119,81089,-2.43
2024-01-01,D043,5360,66959,72319,68290,5.9
2024-01-02,D043,6912,84743,91655,91439,0.24
2024-01-07,D043,5778,98716,104494,105268,-0.74
2024-01-21,D043,6970,84846,91816,90474,1.48
2024-01-21,D043,5243,67073,72316,71316,1.4
2024-01-21,D043,3406,91974,95380,93949,1.52
2024-01-22,D043,4390,58418,62808,62293,0.83
2024-01-28,D043,6220,69875,76095,72672,4.71
2024-01-28,D043,3135,61164,64299,60751,5.84
2024-01-29,D043,4897,72135,77032,74064,4.01
2024-02-05,D043,3658,94293,97951,96959,1.02
2024-02-09,D043,5533,93936,99469,100202,-0.73
2024-02-10,D043,3180,67861,71041,73471,-3.31
2024-02-12,D043,3646,86724,90370,87313,3.5
2024-02-12,D043,6823,95002,101825,102919,-1.06
2024-02-19,D043,3514,60983,64497,64719,-0.34
2024-02-20,D043,4652,71924,76576,75435,1.51
2024-03-02,D043,4279,97664,101943,97895,4.14
2024-03-03,D043,5194,86323,91517,87044,5.14
2024-03-23,D043,4116,59609,63725,61806,3.1
2024-03-24,D043,4986,60942,65928,67854,-2.84
2024-03-27,D043,4101,75666,79767,79861,-0.12
2024-04-08,D043,5663,76162,81825,77296,5.86
2024-04-10,D043,5307,89901,95208,95195,0.01
2024-04-10,D043,6809,93371,100180,101073,-0.88
2024-04-16,D043,4214,84783,88997,85324,4.3
2024-04-17,D043,5312,61468,66780,62534,6.79
2024-04-18,D043,4395,81076,85471,82147,4.05
2024-04-21,D043,4151,57715,61866,61049,1.34
2024-04-25,D043,6912,65945,72857,75602,-3.63
2024-05-02,D043,4211,91701,95912,96871,-0.99
2024-05-02,D043,6901,77803,84704,81260,4.24
2024-05-04,D043,5348,54874,60222,57647,4.47
2024-05-05,D043,3216,73857,77073,76205,1.14
2024-05-07,D043,5754,65186,70940,72523,-2.18
2024-05-13,D043,5030,98068,103098,104648,-1.48
2024-05-20,D043,6939,83894,90833,90536,0.33
2024-05-20,D043,6147,83800,89947,86608,3.86
2024-05-22,D043,3341,55435,58776,54508,7.83
2024-05-22,D043,6107,99454,105561,104028,1.47
2024-05-28,D043,6905,66821,73726,74524,-1.07
2024-05-29,D043,4491,51989,56480,51612,9.43
2024-06-01,D043,4299,98175,102474,103216,-0.72
2024-06-04,D043,6047,60619,66666,62812,6.14
2024-06-05,D043,5922,99510,105432,104655,0.74
2024-06-06,D043,4574,86766,91340,92211,-0.94
2024-06-07,D043,5248,53558,58806,60226,-2.36
2024-06-08,D043,5892,86881,92773,90551,2.45
2024-06-10,D043,6044,64621,70665,70523,0.2
2024-06-13,D043,3705,83001,86706,88315,-1.82
2024-06-24,D043,3722,96622,100344,102598,-2.2
2024-07-05,D043,3301,58391,61692,61752,-0.1
2024-07-06,D043,3775,65445,69220,66265,4.46
2024-07-08,D043,6188,74846,81034,79169,2.36
2024-07-19,D043,3153,90385,93538,95014,-1.55
2024-07-19,D043,4158,70751,74909,73279,2.22
2024-07-20,D043,3633,82252,85885,81089,5.91
2024-07-26,D043,5984,76754,82738,81931,0.98
2024-07-26,D043,4865,63503,68368,65577,4.26
2024-07-28,D043,4771,83189,87960,85420,2.97
2024-08-01,D043,6734,90437,97171,96825,0.36
2024-08-07,D043,4464,52611,57075,54384,4.95
2024-08-10,D043,3212,61545,64757,63621,1.79
2024-08-14,D043,4548,57480,62028,62932,-1.44
2024-08-19,D043,6078,57971,64049,60356,6.12
2024-08-24,D043,3170,67458,70628,68181,3.59
2024-08-26,D043,4531,90940,95471,95126,0.36
2024-09-01,D043,4925,59664,64589,66490,-2.86
2024-09-02,D043,6247,89974,96221,93625,2.77
2024-09-06,D043,3189,73238,76427,73824,3.53
2024-09-07,D043,4959,80699,85658,85366,0.34
2024-09-13,D043,3871,66878,70749,67189,5.3
2024-09-19,D043,6452,99712,106164,107252,-1.01
2024-09-29,D043,3847,91401,95248,95698,-0.47
2024-09-29,D043,6960,61962,68922,71388,-3.45
2024-10-02,D043,4939,50788,55727,53782,3.62
2024-10-09,D043,4567,98785,103352,101077,2.25
2024-10-09,D043,4576,79007,83583,84374,-0.94
2024-10-21,D043,3188,96032,99220,97022,2.27
2024-10-22,D043,5224,53412,58636,61580,-4.78
2024-10-25,D043,3244,52895,56139,52546,6.84
2024-10-31,D043,4944,94105,99049,94422,4.9
2024-11-05,D043,5135,58003,63138,59007,7
2024-11-13,D043,3995,64548,68543,71291,-3.85
2024-11-23,D043,5112,58556,63668,61752,3.1
2024-12-02,D043,6005,74058,80063,78603,1.86
2024-12-03,D043,4686,80412,85098,82659,2.95
2024-12-06,D043,3471,98920,102391,99585,2.82
2024-12-07,D043,6442,66191,72633,72922,-0.4
2024-12-08,D043,3707,82563,86270,84071,2.62
2024-12-10,D043,3294,88256,91550,90523,1.13
2024-12-13,D043,3141,61408,64549,64710,-0.25
2024-12-22,D043,3815,94100,97915,94249,3.89
2024-12-31,D043,3783,61322,65105,63829,2
2024-01-08,D044,6401,96404,102805,102620,0.18
2024-01-12,D044,3818,60360,64178,62138,3.28
2024-01-12,D044,6989,83100,90089,87750,2.67
2024-01-13,D044,3663,90363,94026,92106,2.08
2024-01-15,D044,4679,60316,64995,61891,5.02
2024-01-16,D044,6008,94783,100791,96750,4.18
2024-01-25,D044,5192,53596,58788,58505,0.48
2024-02-07,D044,6770,71699,78469,80715,-2.78
2024-02-07,D044,3866,60619,64485,60335,6.88
2024-02-15,D044,6463,83910,90373,86297,4.72
2024-02-17,D044,5428,56200,61628,59232,4.05
2024-02-17,D044,4775,66218,70993,71733,-1.03
2024-02-20,D044,3530,59335,62865,64006,-1.78
2024-02-27,D044,4825,75338,80163,80840,-0.84
2024-03-01,D044,4077,73065,77142,77247,-0.14
2024-03-04,D044,3030,66363,69393,68251,1.67
2024-03-18,D044,6297,64497,70794,71978,-1.64
2024-03-22,D044,4989,89825,94814,89924,5.44
2024-03-23,D044,6289,71217,77506,76653,1.11
2024-04-06,D044,4577,91971,96548,97274,-0.75
2024-04-07,D044,4838,92320,97158,95000,2.27
2024-04-09,D044,5299,72485,77784,79684,-2.38
2024-04-11,D044,5009,94298,99307,95297,4.21
2024-04-12,D044,3561,76997,80558,78841,2.18
2024-04-14,D044,3159,97857,101016,97692,3.4
2024-04-15,D044,5461,59557,65018,66775,-2.63
2024-04-15,D044,5972,88878,94850,90895,4.35
2024-04-30,D044,4859,90984,95843,95340,0.53
2024-05-01,D044,4354,55620,59974,59220,1.27
2024-05-04,D044,6909,75664,82573,84781,-2.6
2024-05-09,D044,3148,63105,66253,67509,-1.86
2024-05-16,D044,3366,93919,97285,100102,-2.81
2024-05-19,D044,4725,88379,93104,89977,3.48
2024-05-29,D044,6877,72770,79647,80837,-1.47
2024-06-03,D044,3866,98025,101891,101443,0.44
2024-06-09,D044,6792,78399,85191,81717,4.25
2024-06-12,D044,5653,81574,87227,85087,2.52
2024-06-13,D044,3320,86725,90045,90663,-0.68
2024-06-18,D044,5343,83120,88463,88508,-0.05
2024-06-30,D044,5214,75289,80503,77526,3.84
2024-07-06,D044,6640,57710,64350,65731,-2.1
2024-07-18,D044,6735,74594,81329,83205,-2.25
2024-07-22,D044,5259,68028,73287,71916,1.91
2024-07-30,D044,3667,79265,82932,78170,6.09
2024-08-03,D044,5280,95760,101040,99382,1.67
2024-08-05,D044,4695,76309,81004,78469,3.23
2024-08-07,D044,5205,93484,98689,100620,-1.92
2024-08-07,D044,6256,70014,76270,72667,4.96
2024-08-09,D044,3762,92808,96570,93026,3.81
2024-08-12,D044,3941,63453,67394,66675,1.08
2024-08-15,D044,5830,58234,64064,66121,-3.11
2024-08-16,D044,6973,76898,83871,85318,-1.7
2024-08-17,D044,5972,68429,74401,73465,1.27
2024-08-18,D044,3719,50074,53793,55500,-3.08
2024-08-21,D044,4318,96994,101312,98758,2.59
2024-08-25,D044,4157,51996,56153,53842,4.29
2024-08-26,D044,5424,87129,92553,88484,4.6
2024-08-27,D044,3881,84828,88709,85224,4.09
2024-09-01,D044,6326,72560,78886,80840,-2.42
2024-09-03,D044,3004,89142,92146,87778,4.98
2024-09-03,D044,3246,99916,103162,103740,-0.56
2024-09-07,D044,4202,95719,99921,98801,1.13
2024-09-09,D044,6301,51542,57843,55550,4.13
2024-09-10,D044,3480,88031,91511,90417,1.21
2024-09-16,D044,6788,76563,83351,80585,3.43
2024-09-20,D044,3034,64541,67575,67423,0.23
2024-09-29,D044,6232,86526,92758,89761,3.34
2024-10-02,D044,6060,63731,69791,68689,1.6
2024-10-04,D044,6764,90634,97398,98385,-1
2024-10-07,D044,5097,57181,62278,60025,3.75
2024-10-07,D044,6199,86068,92267,90037,2.48
2024-10-08,D044,4710,56305,61015,61617,-0.98
2024-10-09,D044,4094,63715,67809,65128,4.12
2024-10-09,D044,5925,64515,70440,72320,-2.6
2024-10-13,D044,6754,81820,88574,84359,5
2024-10-17,D044,6185,68300,74485,70445,5.73
2024-10-22,D044,6052,82036,88088,86659,1.65
2024-10-29,D044,5594,67110,72704,70878,2.58
2024-10-29,D044,6066,71256,77322,79876,-3.2
2024-10-29,D044,3470,51987,55457,58367,-4.99
2024-10-30,D044,3131,57588,60719,62816,-3.34
2024-11-01,D044,4174,83932,88106,90014,-2.12
2024-11-01,D044,3477,77302,80779,80688,0.11
2024-11-03,D044,4581,50658,55239,53416,3.41
2024-11-07,D044,5203,67774,72977,74235,-1.69
2024-11-29,D044,4908,58567,63475,62945,0.84
2024-11-30,D044,4064,53134,57198,58128,-1.6
2024-12-02,D044,5466,76514,81980,83041,-1.28
2024-12-05,D044,4763,58712,63475,60678,4.61
2024-12-10,D044,6632,91434,98066,99984,-1.92
2024-12-21,D044,5025,59795,64820,60609,6.95
2024-12-27,D044,6425,78475,84900,84308,0.7
2024-12-29,D044,4264,70614,74878,74717,0.22
2024-01-08,D045,3207,96716,99923,101777,-1.82
2024-01-09,D045,6392,52106,58498,56021,4.42
2024-01-14,D045,5790,91628,97418,99919,-2.5
2024-01-16,D045,5543,78702,84245,82988,1.51
2024-01-16,D045,4764,54290,59054,56172,5.13
2024-01-16,D045,6596,76979,83575,82124,1.77
2024-01-21,D045,3669,51283,54952,57029,-3.64
2024-01-25,D045,6582,81521,88103,85405,3.16
2024-01-29,D045,4042,67198,71240,72825,-2.18
2024-01-31,D045,4764,56009,60773,59315,2.46
2024-02-04,D045,4307,69814,74121,70597,4.99
2024-02-04,D045,6110,50661,56771,57299,-0.92
2024-02-04,D045,5749,72499,78248,77000,1.62
2024-02-10,D045,4180,99216,103396,103828,-0.42
2024-02-16,D045,6211,60485,66696,65964,1.11
2024-02-20,D045,5804,67833,73637,76091,-3.23
2024-02-20,D045,5485,55895,61380,61026,0.58
2024-03-01,D045,3122,87571,90693,91316,-0.68
2024-03-06,D045,4093,53880,57973,58479,-0.87
2024-03-06,D045,4202,71258,75460,72898,3.51
2024-03-09,D045,3862,87044,90906,85909,5.82
2024-03-17,D045,3368,73360,76728,75107,2.16
2024-03-17,D045,4927,97738,102665,101365,1.28
2024-03-17,D045,6248,64678,70926,70195,1.04
2024-03-18,D045,4360,66267,70627,71743,-1.56
2024-03-19,D045,3621,64327,67948,63564,6.9
2024-03-19,D045,3463,88785,92248,92596,-0.38
2024-03-22,D045,5881,56476,62357,62753,-0.63
2024-03-27,D045,3457,63890,67347,63751,5.64
2024-03-28,D045,3481,98737,102218,104619,-2.29
2024-03-30,D045,5150,83755,88905,88584,0.36
2024-03-30,D045,6413,90795,97208,92249,5.38
2024-03-30,D045,3228,66533,69761,66887,4.3
2024-04-06,D045,3032,60886,63918,61032,4.73
2024-04-07,D045,6798,58996,65794,68720,-4.26
2024-04-12,D045,3959,55622,59581,56617,5.24
2024-04-14,D045,5542,57938,63480,62339,1.83
2024-04-14,D045,5395,63080,68475,65098,5.19
2024-04-20,D045,5025,78288,83313,85549,-2.61
2024-04-25,D045,6926,79961,86887,85477,1.65
2024-04-26,D045,6015,74767,80782,80947,-0.2
2024-04-30,D045,3992,64746,68738,67470,1.88
2024-05-02,D045,4423,97802,102225,100165,2.06
2024-05-05,D045,4775,61573,66348,64323,3.15
2024-05-05,D045,3490,69937,73427,71987,2
2024-05-13,D045,3238,69920,73158,70459,3.83
2024-05-19,D045,4932,88215,93147,91588,1.7
2024-05-25,D045,5927,86527,92454,90342,2.34
2024-05-25,D045,4751,52303,57054,53083,7.48
2024-05-25,D045,5158,56371,61529,60323,2
2024-05-29,D045,4511,70758,75269,77187,-2.48
2024-05-30,D045,3452,60589,64041,65066,-1.58
2024-06-02,D045,3525,65034,68559,66128,3.68
2024-06-03,D045,5304,73027,78331,74899,4.58
2024-06-04,D045,6309,76999,83308,82131,1.43
2024-06-06,D045,6681,91205,97886,97983,-0.1
2024-06-07,D045,6273,61221,67494,68159,-0.98
2024-06-08,D045,3163,91424,94587,94545,0.04
2024-06-08,D045,6008,98293,104301,103001,1.26
2024-06-09,D045,5448,95253,100701,102418,-1.68
2024-06-11,D045,3449,92314,95763,91343,4.84
2024-06-15,D045,3390,67038,70428,67593,4.19
2024-06-18,D045,6761,87564,94325,92719,1.73
2024-06-28,D045,5510,80289,85799,88787,-3.37
2024-07-01,D045,4156,85829,89985,85828,4.84
2024-07-05,D045,5545,66983,72528,69694,4.07
2024-07-12,D045,3109,71555,74664,69882,6.84
2024-07-17,D045,6559,58431,64990,67852,-4.22
2024-07-17,D045,3591,50582,54173,49851,8.67
2024-07-18,D045,3402,62901,66303,62363,6.32
2024-07-23,D045,6843,71949,78792,77248,2
2024-07-25,D045,6099,86175,92274,88543,4.21
2024-08-06,D045,4510,76535,81045,81537,-0.6
2024-08-12,D045,6041,89159,95200,92500,2.92
2024-08-15,D045,5687,88362,94049,93254,0.85
2024-08-15,D045,4373,78854,83227,79971,4.07
2024-08-16,D045,6448,77285,83733,84409,-0.8
2024-08-26,D045,3951,90150,94101,90870,3.56
2024-08-28,D045,3866,80119,83985,86844,-3.29
2024-08-30,D045,5874,80641,86515,82080,5.4
2024-09-02,D045,6107,70852,76959,74352,3.51
2024-09-03,D045,6839,52675,59514,55810,6.64
2024-09-09,D045,6069,82917,88986,90940,-2.15
2024-09-12,D045,5841,95650,101491,102337,-0.83
2024-09-21,D045,4565,86435,91000,91787,-0.86
2024-09-21,D045,6646,62747,69393,70080,-0.98
2024-09-24,D045,5492,53311,58803,55755,5.47
2024-10-03,D045,6298,79416,85714,88163,-2.78
2024-10-05,D045,6569,90475,97044,99298,-2.27
2024-10-26,D045,4668,56469,61137,58608,4.32
2024-11-01,D045,6535,68677,75212,77108,-2.46
2024-11-03,D045,4359,51969,56328,56535,-0.37
2024-11-04,D045,6527,57642,64169,60926,5.32
2024-11-06,D045,6582,72333,78915,74149,6.43
2024-11-11,D045,3246,81153,84399,82187,2.69
2024-11-12,D045,3814,70559,74373,74440,-0.09
2024-11-13,D045,5854,61577,67431,66860,0.85
2024-11-20,D045,5973,92359,98332,97917,0.42
2024-11-28,D045,5496,55577,61073,60455,1.02
2024-12-04,D045,5314,91420,96734,95970,0.8
2024-12-08,D045,5699,60928,66627,64798,2.82
2024-12-10,D045,6337,65945,72282,70193,2.98
2024-12-18,D045,5847,71586,77433,75089,3.12
2024-12-22,D045,4236,87437,91673,90529,1.26
2024-12-23,D045,6932,61460,68392,70808,-3.41
2024-12-24,D045,6689,58328,65017,61684,5.4
2024-12-26,D045,6787,69708,76495,74234,3.05
2024-12-27,D045,5606,61130,66736,63452,5.18
2024-12-31,D045,6401,90042,96443,95122,1.39
2024-01-04,D046,4238,65064,69302,65763,5.38
2024-01-04,D046,3733,68369,72102,71810,0.41
2024-01-04,D046,5713,91401,97114,98038,-0.94
2024-01-09,D046,6542,50160,56702,52246,8.53
2024-01-10,D046,3968,50368,54336,57104,-4.85
2024-01-13,D046,6748,68199,74947,74106,1.13
2024-01-18,D046,4621,52696,57317,55309,3.63
2024-01-19,D046,3564,51620,55184,52792,4.53
2024-01-19,D046,4603,67625,72228,74103,-2.53
2024-01-25,D046,4676,98244,102920,103391,-0.46
2024-01-27,D046,4755,66378,71133,73455,-3.16
2024-01-29,D046,3930,97599,101529,103516,-1.92
2024-01-30,D046,3125,73908,77033,73490,4.82
2024-01-30,D046,5104,92215,97319,93518,4.06
2024-01-31,D046,4521,63560,68081,70477,-3.4
2024-02-03,D046,4968,76329,81297,78365,3.74
2024-02-03,D046,6240,56665,62905,61176,2.83
2024-02-07,D046,4159,79092,83251,85009,-2.07
2024-02-14,D046,3000,94199,97199,96508,0.72
2024-02-15,D046,4994,87389,92383,88643,4.22
2024-02-15,D046,6965,89952,96917,98316,-1.42
2024-02-28,D046,6936,71602,78538,77513,1.32
2024-03-01,D046,6856,59776,66632,64693,3
2024-03-07,D046,6453,63397,69850,72064,-3.07
2024-03-07,D046,6268,84445,90713,86735,4.59
2024-03-09,D046,4372,57999,62371,59319,5.15
2024-03-10,D046,4189,69073,73262,72167,1.52
2024-03-13,D046,3083,78730,81813,83769,-2.33
2024-03-26,D046,4655,55374,60029,58239,3.07
2024-03-27,D046,4634,51934,56568,54396,3.99
2024-04-03,D046,3393,96489,99882,97800,2.13
2024-04-04,D046,5111,72940,78051,73241,6.57
2024-04-12,D046,3120,52466,55586,56189,-1.07
2024-04-17,D046,6075,53164,59239,59273,-0.06
2024-04-20,D046,4898,64693,69591,69282,0.45
2024-04-22,D046,5935,62258,68193,64928,5.03
2024-04-26,D046,5378,84142,89520,89317,0.23
2024-05-14,D046,3662,64571,68233,69474,-1.79
2024-05-21,D046,3971,72386,76357,72743,4.97
2024-05-21,D046,5019,66843,71862,67294,6.79
2024-05-22,D046,6522,83550,90072,86622,3.98
2024-05-31,D046,4325,94682,99007,100296,-1.29
2024-05-31,D046,5378,98665,104043,103589,0.44
2024-06-11,D046,3684,87001,90685,93108,-2.6
2024-06-11,D046,4588,99057,103645,104083,-0.42
2024-06-25,D046,6433,69238,75671,75776,-0.14
2024-06-26,D046,6759,52103,58862,61497,-4.28
2024-06-27,D046,4802,65627,70429,72009,-2.19
2024-06-30,D046,3024,91115,94139,93551,0.63
2024-07-01,D046,6339,57489,63828,65293,-2.24
2024-07-04,D046,5773,66689,72462,67731,6.98
2024-07-06,D046,5799,88241,94040,97022,-3.07
2024-07-20,D046,3213,87371,90584,88390,2.48
2024-07-21,D046,3947,56791,60738,56567,7.37
2024-07-21,D046,3758,58938,62696,65104,-3.7
2024-07-25,D046,5611,93056,98667,96542,2.2
2024-07-29,D046,3405,99815,103220,105088,-1.78
2024-08-03,D046,5121,95678,100799,98577,2.25
2024-08-04,D046,3462,72555,76017,76257,-0.31
2024-08-04,D046,4930,54551,59481,59658,-0.3
2024-08-19,D046,5317,98043,103360,98746,4.67
2024-09-02,D046,5239,76578,81817,79369,3.08
2024-09-02,D046,4810,52591,57401,57705,-0.53
2024-09-11,D046,4707,73471,78178,76391,2.34
2024-09-12,D046,3520,96045,99565,101425,-1.83
2024-09-12,D046,5510,66484,71994,71907,0.12
2024-09-13,D046,6417,65704,72121,73698,-2.14
2024-09-16,D046,3187,83848,87035,84999,2.4
2024-09-19,D046,6151,73291,79442,81834,-2.92
2024-09-25,D046,3922,77526,81448,76491,6.48
2024-09-27,D046,6451,78274,84725,83672,1.26
2024-09-28,D046,3631,84131,87762,86254,1.75
2024-09-30,D046,6626,60447,67073,64025,4.76
2024-10-01,D046,3742,98943,102685,105600,-2.76
2024-10-02,D046,5427,55750,61177,56742,7.82
2024-10-14,D046,6598,75256,81854,79425,3.06
2024-10-16,D046,3800,97963,101763,103517,-1.69
2024-10-27,D046,5427,85609,91036,93423,-2.56
2024-10-28,D046,6096,81508,87604,89621,-2.25
2024-11-03,D046,4955,85739,90694,87217,3.99
2024-11-06,D046,4426,59884,64310,65517,-1.84
2024-11-09,D046,3605,95430,99035,95253,3.97
2024-11-18,D046,3998,65942,69940,65097,7.44
2024-11-28,D046,3821,69868,73689,73004,0.94
2024-12-03,D046,6777,52869,59646,59412,0.39
2024-12-03,D046,6149,59729,65878,61390,7.31
2024-12-03,D046,4200,55868,60068,58189,3.23
2024-12-06,D046,4481,79318,83799,78860,6.26
2024-12-18,D046,5764,98777,104541,107070,-2.36
2024-12-23,D046,5880,51014,56894,57983,-1.88
2024-12-25,D046,3212,83716,86928,85984,1.1
2024-12-28,D046,5443,60457,65900,66712,-1.22
2024-01-01,D047,4576,74111,78687,74617,5.45
2024-01-01,D047,6037,52749,58786,61196,-3.94
2024-01-01,D047,4067,85554,89621,86659,3.42
2024-01-06,D047,4259,71630,75889,71618,5.96
2024-01-10,D047,5970,82779,88749,86367,2.76
2024-01-12,D047,6712,78531,85243,83714,1.83
2024-01-13,D047,6453,86023,92476,94259,-1.89
2024-01-14,D047,3503,85046,88549,85445,3.63
2024-01-15,D047,4896,95714,100610,101537,-0.91
2024-01-23,D047,4128,63986,68114,63368,7.49
2024-01-27,D047,6523,65823,72346,70291,2.92
2024-02-07,D047,3642,80565,84207,82857,1.63
2024-02-09,D047,6590,68093,74683,71901,3.87
2024-02-11,D047,6933,65775,72708,72861,-0.21
2024-02-13,D047,3609,90708,94317,95161,-0.89
2024-02-17,D047,4770,63432,68202,69680,-2.12
2024-02-20,D047,4899,51267,56166,52191,7.62
2024-02-22,D047,3791,62185,65976,62616,5.37
2024-03-03,D047,5784,72520,78304,75819,3.28
2024-03-12,D047,6516,95710,102226,97237,5.13
2024-03-16,D047,6080,73625,79705,81752,-2.5
2024-03-19,D047,6999,77570,84569,85063,-0.58
2024-03-19,D047,4445,73437,77882,77681,0.26
2024-03-22,D047,5853,93829,99682,97487,2.25
2024-03-29,D047,5234,93826,99060,95995,3.19
2024-04-08,D047,3115,90205,93320,95874,-2.66
2024-04-08,D047,3525,56337,59862,61682,-2.95
2024-04-09,D047,5086,66285,71371,72061,-0.96
2024-04-19,D047,6271,95482,101753,104544,-2.67
2024-04-21,D047,4942,55520,60462,60144,0.53
2024-04-21,D047,3655,97553,101208,101440,-0.23
2024-04-24,D047,4439,92750,97189,99195,-2.02
2024-04-25,D047,4723,73608,78331,78009,0.41
2024-04-26,D047,4147,89310,93457,89521,4.4
2024-05-02,D047,4209,62771,66980,67253,-0.41
2024-05-08,D047,4872,79377,84249,83253,1.2
2024-05-10,D047,6840,67412,74252,69867,6.28
2024-05-11,D047,4043,68313,72356,68677,5.36
2024-05-13,D047,4089,97382,101471,99618,1.86
2024-05-14,D047,5701,98381,104082,101403,2.64
2024-05-15,D047,3181,62552,65733,65915,-0.28
2024-05-16,D047,5279,65327,70606,69043,2.26
2024-05-16,D047,4378,76515,80893,76515,5.72
2024-05-23,D047,3884,87259,91143,86951,4.82
2024-05-30,D047,4073,56787,60860,59393,2.47
2024-06-04,D047,5338,99257,104595,102056,2.49
2024-06-07,D047,5536,86081,91617,91776,-0.17
2024-06-11,D047,3018,60503,63521,63680,-0.25
2024-06-16,D047,6552,88029,94581,91082,3.84
2024-06-25,D047,4280,52920,57200,52499,8.95
2024-07-05,D047,5413,59442,64855,60570,7.07
2024-07-15,D047,4939,69978,74917,73076,2.52
2024-07-22,D047,5212,76928,82140,81572,0.7
2024-07-24,D047,3928,95807,99735,101318,-1.56
2024-07-25,D047,6389,55914,62303,63523,-1.92
2024-07-27,D047,3092,71133,74225,73720,0.69
2024-07-28,D047,4536,88969,93505,93341,0.18
2024-08-16,D047,6297,70914,77211,75234,2.63
2024-08-19,D047,6952,79259,86211,88225,-2.28
2024-08-20,D047,6376,88413,94789,92527,2.44
2024-08-21,D047,6349,74028,80377,76817,4.63
2024-08-21,D047,5350,52654,58004,60014,-3.35
2024-08-25,D047,4127,63521,67648,63951,5.78
2024-08-25,D047,5381,66489,71870,71317,0.78
2024-08-26,D047,5351,85113,90464,93389,-3.13
2024-09-02,D047,3282,82263,85545,80582,6.16
2024-09-05,D047,6734,90118,96852,92861,4.3
2024-09-16,D047,3739,54030,57769,52910,9.18
2024-09-16,D047,3902,83132,87034,85776,1.47
2024-09-18,D047,3783,98367,102150,100141,2.01
2024-09-19,D047,3266,72886,76152,75764,0.51
2024-09-20,D047,6489,57970,64459,65316,-1.31
2024-09-24,D047,6988,64633,71621,69185,3.52
2024-09-24,D047,5644,81731,87375,90310,-3.25
2024-09-27,D047,5018,99592,104610,101654,2.91
2024-10-01,D047,3460,71097,74557,74465,0.12
2024-10-02,D047,4686,79379,84065,82053,2.45
2024-10-08,D047,3851,73401,77252,72481,6.58
2024-10-14,D047,3081,67229,70310,70501,-0.27
2024-10-15,D047,3037,93032,96069,94564,1.59
2024-10-15,D047,6005,86320,92325,95307,-3.13
2024-10-16,D047,4119,57805,61924,59687,3.75
2024-11-08,D047,3537,67304,70841,72764,-2.64
2024-11-12,D047,3815,95714,99529,94846,4.94
2024-11-16,D047,3730,65928,69658,67768,2.79
2024-11-17,D047,4840,61719,66559,64162,3.74
2024-11-17,D047,4437,69233,73670,69609,5.83
2024-11-24,D047,6814,81730,88544,85510,3.55
2024-11-27,D047,5485,94619,100104,96787,3.43
2024-11-27,D047,6109,70466,76575,73945,3.56
2024-12-02,D047,4917,84022,88939,84464,5.3
2024-12-03,D047,4337,83866,88203,84107,4.87
2024-12-04,D047,3777,85163,88940,91912,-3.23
2024-12-05,D047,5897,96737,102634,101601,1.02
2024-12-16,D047,3524,59079,62603,65396,-4.27
2024-12-24,D047,6007,80810,86817,83684,3.74
2024-12-24,D047,3144,68706,71850,72294,-0.61
2024-12-25,D047,6664,85268,91932,88406,3.99
2024-12-30,D047,6925,60450,67375,66336,1.57
2024-01-02,D048,6520,64011,70531,70665,-0.19
2024-01-07,D048,3329,66032,69361,70163,-1.14
2024-01-09,D048,6899,56477,63376,58876,7.64
2024-01-10,D048,5280,54131,59411,59951,-0.9
2024-01-24,D048,4314,64690,69004,65665,5.08
2024-01-25,D048,4609,50717,55326,54765,1.02
2024-01-27,D048,4003,60306,64309,64720,-0.64
2024-01-27,D048,6347,59867,66214,68916,-3.92
2024-01-30,D048,6168,68682,74850,73772,1.46
2024-02-02,D048,5401,76940,82341,84052,-2.04
2024-02-08,D048,6560,86483,93043,89358,4.12
2024-02-08,D048,5334,51001,56335,58302,-3.37
2024-02-16,D048,4909,70195,75104,74482,0.84
2024-02-20,D048,4834,82353,87187,86165,1.19
2024-02-24,D048,3303,96546,99849,100874,-1.02
2024-02-26,D048,6137,50097,56234,56019,0.38
2024-03-01,D048,3336,79721,83057,79110,4.99
2024-03-03,D048,5343,78658,84001,81798,2.69
2024-03-06,D048,5741,99574,105315,105552,-0.22
2024-03-09,D048,5103,56774,61877,57506,7.6
2024-03-09,D048,5408,94633,100041,99750,0.29
2024-03-16,D048,5696,81369,87065,83426,4.36
2024-03-27,D048,3182,50164,53346,49388,8.01
2024-03-27,D048,6369,91899,98268,100743,-2.46
2024-03-29,D048,5142,70282,75424,71988,4.77
2024-03-29,D048,3487,99012,102499,100507,1.98
2024-03-30,D048,3913,79125,83038,86002,-3.45
2024-04-05,D048,4880,77750,82630,85229,-3.05
2024-04-12,D048,4568,59174,63742,63582,0.25
2024-04-21,D048,3877,89941,93818,89745,4.54
2024-04-26,D048,6292,51177,57469,55709,3.16
2024-04-26,D048,6237,54136,60373,58849,2.59
2024-04-30,D048,3524,65775,69299,70089,-1.13
2024-05-04,D048,6750,77733,84483,82800,2.03
2024-05-05,D048,6565,62334,68899,64014,7.63
2024-05-09,D048,5643,51299,56942,54124,5.21
2024-05-12,D048,3324,73871,77195,78666,-1.87
2024-05-16,D048,6072,82490,88562,89634,-1.2
2024-05-17,D048,4361,76149,80510,80824,-0.39
2024-05-17,D048,6340,70195,76535,76263,0.36
2024-05-21,D048,3448,79263,82711,85630,-3.41
2024-05-28,D048,4201,75511,79712,82331,-3.18
2024-06-14,D048,5197,85690,90887,87401,3.99
2024-06-17,D048,5828,83130,88958,89354,-0.44
2024-06-19,D048,4318,92495,96813,95029,1.88
2024-06-19,D048,4161,90168,94329,94950,-0.65
2024-06-20,D048,3264,76562,79826,74837,6.67
2024-06-21,D048,6629,52887,59516,56137,6.02
2024-06-23,D048,5156,84998,90154,88867,1.45
2024-07-02,D048,4855,57866,62721,58464,7.28
2024-07-03,D048,6950,54934,61884,62672,-1.26
2024-07-09,D048,4348,55289,59637,60215,-0.96
2024-07-12,D048,6807,86487,93294,93713,-0.45
2024-07-16,D048,4394,81692,86086,83470,3.13
2024-07-18,D048,4887,90478,95365,96540,-1.22
2024-07-30,D048,5148,83324,88472,86271,2.55
2024-08-04,D048,4365,50698,55063,50877,8.23
2024-08-05,D048,3615,58062,61677,61039,1.05
2024-08-13,D048,4801,60338,65139,62561,4.12
2024-08-19,D048,3617,71601,75218,72831,3.28
2024-08-23,D048,6104,78400,84504,85127,-0.73
2024-08-28,D048,5024,79430,84454,83196,1.51
2024-08-29,D048,6028,59045,65073,64341,1.14
2024-08-31,D048,6240,52631,58871,59685,-1.36
2024-09-04,D048,4813,77491,82304,84695,-2.82
2024-09-06,D048,4249,73192,77441,76885,0.72
2024-09-09,D048,4340,79086,83426,79164,5.38
2024-09-11,D048,6374,65254,71628,71350,0.39
2024-09-12,D048,5457,78261,83718,86613,-3.34
2024-09-13,D048,3357,68632,71989,68402,5.24
2024-09-14,D048,6779,76571,83350,84383,-1.22
2024-09-17,D048,4645,79049,83694,84907,-1.43
2024-09-18,D048,3763,79602,83365,81046,2.86
2024-09-21,D048,6342,98733,105075,102290,2.72
2024-09-24,D048,4161,67413,71574,70237,1.9
2024-09-25,D048,4654,79482,84136,86949,-3.24
2024-09-27,D048,4600,66727,71327,73121,-2.45
2024-09-28,D048,3592,57413,61005,57003,7.02
2024-09-29,D048,4670,62807,67477,69326,-2.67
2024-10-06,D048,3078,92738,95816,94016,1.91
2024-10-10,D048,3972,95648,99620,97387,2.29
2024-10-18,D048,4845,96710,101555,104173,-2.51
2024-10-19,D048,6726,77042,83768,85781,-2.35
2024-10-19,D048,3798,61467,65265,67655,-3.53
2024-10-26,D048,6556,51079,57635,55554,3.75
2024-10-27,D048,5485,75443,80928,77685,4.17
2024-10-29,D048,6243,99800,106043,103948,2.02
2024-11-03,D048,5725,89386,95111,92444,2.88
2024-11-03,D048,5193,93007,98200,98096,0.11
2024-11-09,D048,4299,84721,89020,91632,-2.85
2024-11-14,D048,3267,93809,97076,95727,1.41
2024-11-14,D048,5773,55109,60882,57238,6.37
2024-11-15,D048,6357,56472,62829,59833,5.01
2024-11-20,D048,4379,86953,91332,89171,2.42
2024-11-21,D048,5637,66450,72087,67744,6.41
2024-11-23,D048,4521,91786,96307,94485,1.93
2024-11-23,D048,6136,69673,75809,76199,-0.51
2024-11-24,D048,4863,66499,71362,67278,6.07
2024-11-25,D048,5112,96660,101772,97538,4.34
2024-12-02,D048,5079,76570,81649,77384,5.51
2024-12-06,D048,4578,79427,84005,84777,-0.91
2024-12-10,D048,6231,52597,58828,53999,8.94
2024-12-16,D048,6218,68312,74530,69787,6.8
2024-12-18,D048,4755,90456,95211,95640,-0.45
2024-12-24,D048,5946,72211,78157,76253,2.5
2024-12-24,D048,5587,75599,81186,78514,3.4
2024-12-30,D048,4856,67749,72605,75106,-3.33
2024-01-02,D049,3641,97323,100964,98279,2.73
2024-01-02,D049,5944,88191,94135,90738,3.74
2024-01-04,D049,4111,58367,62478,64756,-3.52
2024-01-04,D049,3177,87122,90299,92648,-2.54
2024-01-05,D049,6667,55939,62606,59102,5.93
2024-01-08,D049,6071,59106,65177,67890,-4
2024-01-09,D049,3029,81346,84375,79907,5.59
2024-01-09,D049,6170,68297,74467,71595,4.01
2024-01-16,D049,3144,57507,60651,58794,3.16
2024-01-17,D049,3329,86408,89737,88843,1.01
2024-01-24,D049,4407,94462,98869,97831,1.06
2024-01-25,D049,6337,79813,86150,86639,-0.56
2024-01-30,D049,5175,61341,66516,62952,5.66
2024-01-31,D049,5054,59145,64199,60541,6.04
2024-02-02,D049,6186,77122,83308,81503,2.21
2024-02-06,D049,5457,55730,61187,58458,4.67
2024-02-19,D049,4337,74154,78491,81377,-3.55
2024-02-21,D049,3078,63696,66774,64845,2.97
2024-02-26,D049,6645,55105,61750,61828,-0.13
2024-02-28,D049,3968,50835,54803,55557,-1.36
2024-03-03,D049,4334,91366,95700,95851,-0.16
2024-03-03,D049,5419,54279,59698,59350,0.59
2024-03-03,D049,3957,57146,61103,63543,-3.84
2024-03-08,D049,6804,52368,59172,55207,7.18
2024-03-12,D049,6600,55279,61879,64298,-3.76
2024-03-15,D049,3752,62822,66574,64806,2.73
2024-03-20,D049,4030,92255,96285,91379,5.37
2024-03-22,D049,5475,76183,81658,81789,-0.16
2024-04-03,D049,5551,97077,102628,100586,2.03
2024-04-03,D049,3994,80255,84249,82451,2.18
2024-04-09,D049,3395,57400,60795,59624,1.96
2024-04-12,D049,3820,50192,54012,55236,-2.22
2024-04-18,D049,5688,67929,73617,75547,-2.55
2024-04-24,D049,4732,77215,81947,79053,3.66
2024-05-16,D049,5910,57622,63532,64130,-0.93
2024-05-18,D049,3193,65577,68770,68535,0.34
2024-05-19,D049,3558,52048,55606,52373,6.17
2024-05-24,D049,4379,83805,88184,83742,5.3
2024-05-24,D049,5925,53625,59550,57081,4.33
2024-05-24,D049,6484,68225,74709,70978,5.26
2024-05-28,D049,6186,75662,81848,80649,1.49
2024-05-29,D049,6401,51622,58023,55505,4.54
2024-06-16,D049,5912,53324,59236,61796,-4.14
2024-06-18,D049,6539,74229,80768,77728,3.91
2024-06-30,D049,6009,74368,80377,78626,2.23
2024-06-30,D049,3108,77881,80989,77932,3.92
2024-07-02,D049,5878,88762,94640,90424,4.66
2024-07-05,D049,5854,81463,87317,89067,-1.96
2024-07-06,D049,5442,54798,60240,57204,5.31
2024-07-08,D049,4159,87418,91577,90078,1.66
2024-07-10,D049,3317,81337,84654,82172,3.02
2024-07-14,D049,6947,87676,94623,94776,-0.16
2024-07-18,D049,5550,54298,59848,58180,2.87
2024-07-18,D049,5775,65052,70827,67783,4.49
2024-07-19,D049,5432,72841,78273,76407,2.44
2024-07-21,D049,5457,58645,64102,64481,-0.59
2024-07-21,D049,5280,70724,76004,73164,3.88
2024-07-22,D049,6654,89930,96584,97150,-0.58
2024-07-22,D049,4669,72097,76766,78210,-1.85
2024-07-23,D049,3404,68105,71509,67513,5.92
2024-07-30,D049,6727,60596,67323,63153,6.6
2024-08-04,D049,4953,72553,77506,72524,6.87
2024-08-04,D049,6904,59461,66365,64822,2.38
2024-08-04,D049,4034,51469,55503,53778,3.21
2024-08-05,D049,4724,64292,69016,68964,0.08
2024-08-07,D049,4869,95389,100258,98119,2.18
2024-08-15,D049,4726,76582,81308,78517,3.55
2024-08-19,D049,4556,65494,70050,71252,-1.69
2024-08-23,D049,5209,71033,76242,72311,5.44
2024-08-23,D049,5642,65913,71555,72083,-0.73
2024-08-24,D049,6209,79510,85719,87842,-2.42
2024-08-31,D049,5213,61008,66221,65311,1.39
2024-09-01,D049,3150,51134,54284,51685,5.03
2024-09-01,D049,6519,53436,59955,59517,0.74
2024-09-01,D049,3831,77964,81795,81823,-0.03
2024-09-02,D049,6520,61251,67771,66655,1.67
2024-09-08,D049,6412,72580,78992,76743,2.93
2024-09-20,D049,6257,95582,101839,97783,4.15
2024-09-23,D049,3852,73833,77685,76527,1.51
2024-09-25,D049,4024,91505,95529,92964,2.76
2024-09-27,D049,4186,62392,66578,65814,1.16
2024-09-29,D049,6135,56953,63088,58571,7.71
2024-10-12,D049,6215,78071,84286,80100,5.23
2024-10-14,D049,3805,59934,63739,66525,-4.19
2024-10-14,D049,5081,86187,91268,88030,3.68
2024-10-20,D049,3918,83941,87859,87656,0.23
2024-10-23,D049,5050,86053,91103,91248,-0.16
2024-10-24,D049,3951,74611,78562,76359,2.89
2024-10-24,D049,3922,89846,93768,95022,-1.32
2024-10-24,D049,5763,84800,90563,92056,-1.62
2024-10-27,D049,4091,63318,67409,69593,-3.14
2024-10-29,D049,3011,51341,54352,53689,1.23
2024-11-01,D049,5059,82088,87147,86611,0.62
2024-11-07,D049,3928,87797,91725,89489,2.5
2024-11-13,D049,4520,89353,93873,92214,1.8
2024-11-13,D049,3244,62984,66228,68957,-3.96
2024-11-16,D049,4214,92712,96926,97316,-0.4
2024-11-19,D049,3754,96901,100655,102063,-1.38
2024-11-21,D049,4854,73004,77858,78992,-1.44
2024-11-22,D049,3541,60886,64427,62753,2.67
2024-11-26,D049,3350,53793,57143,58073,-1.6
2024-12-02,D049,5602,90030,95632,96359,-0.75
2024-12-02,D049,4107,69816,73923,76235,-3.03
2024-12-07,D049,6681,91735,98416,94648,3.98
2024-12-10,D049,3852,79055,82907,83976,-1.27
2024-12-14,D049,4607,78324,82931,85883,-3.44
2024-12-20,D049,4872,85585,90457,89625,0.93
2024-12-21,D049,6380,92443,98823,96359,2.56
2024-12-30,D049,4199,61848,66047,63968,3.25
2024-01-04,D050,5040,69333,74373,73112,1.72
2024-01-15,D050,3803,78656,82459,78485,5.06
2024-01-21,D050,4175,75474,79649,79995,-0.43
2024-01-28,D050,5779,87732,93511,92375,1.23
2024-01-31,D050,6900,99855,106755,108887,-1.96
2024-02-04,D050,5774,77472,83246,82061,1.44
2024-02-05,D050,6534,90699,97233,93175,4.36
2024-02-10,D050,4479,56677,61156,59690,2.46
2024-02-17,D050,4914,91037,95951,95338,0.64
2024-02-21,D050,6504,70946,77450,79852,-3.01
2024-02-21,D050,3373,57693,61066,59040,3.43
2024-02-23,D050,3461,86007,89468,86718,3.17
2024-02-29,D050,4660,52438,57098,57115,-0.03
2024-03-12,D050,6290,56862,63152,58812,7.38
2024-03-15,D050,3412,57543,60955,56368,8.14
2024-03-25,D050,3992,94823,98815,99523,-0.71
2024-03-25,D050,6766,60934,67700,64553,4.88
2024-03-26,D050,6453,83159,89612,85492,4.82
2024-04-02,D050,5939,75397,81336,79339,2.52
2024-04-03,D050,3167,69385,72552,73814,-1.71
2024-04-04,D050,6792,73776,80568,79526,1.31
2024-04-04,D050,6518,78184,84702,83987,0.85
2024-04-05,D050,4338,50019,54357,56682,-4.1
2024-04-07,D050,6921,56941,63862,65504,-2.51
2024-04-12,D050,3367,59127,62494,61931,0.91
2024-04-16,D050,4945,53435,58380,58179,0.35
2024-04-19,D050,6185,93826,100011,96566,3.57
2024-04-22,D050,6178,99780,105958,101796,4.09
2024-04-23,D050,6255,75921,82176,82220,-0.05
2024-05-09,D050,3638,72641,76279,71913,6.07
2024-05-09,D050,4250,71113,75363,74736,0.84
2024-05-18,D050,5999,94070,100069,103001,-2.85
2024-05-20,D050,3897,67094,70991,70296,0.99
2024-05-23,D050,3288,51409,54697,57684,-5.18
2024-05-25,D050,4411,89696,94107,91739,2.58
2024-05-28,D050,4733,73284,78017,77096,1.19
2024-06-01,D050,3707,65857,69564,72130,-3.56
2024-06-07,D050,5208,96333,101541,102534,-0.97
2024-06-08,D050,3954,53291,57245,59889,-4.41
2024-06-10,D050,6402,51909,58311,60184,-3.11
2024-06-12,D050,3091,74151,77242,75054,2.92
2024-06-14,D050,6862,82826,89688,86967,3.13
2024-06-14,D050,5742,87403,93145,91720,1.55
2024-06-19,D050,6730,78820,85550,81003,5.61
2024-06-26,D050,4612,64842,69454,65319,6.33
2024-06-27,D050,4972,98077,103049,102247,0.78
2024-06-28,D050,5753,85011,90764,86761,4.61
2024-07-07,D050,3290,82263,85553,84717,0.99
2024-07-11,D050,3721,84169,87890,90445,-2.82
2024-07-12,D050,5549,88000,93549,94388,-0.89
2024-07-15,D050,5263,78380,83643,84216,-0.68
2024-07-15,D050,3306,79450,82756,83205,-0.54
2024-07-22,D050,4287,86679,90966,92253,-1.4
2024-07-24,D050,6569,55454,62023,61873,0.24
2024-07-26,D050,4394,50256,54650,55930,-2.29
2024-07-28,D050,3945,61292,65237,62055,5.13
2024-07-30,D050,3664,81389,85053,84516,0.64
2024-07-31,D050,6764,85153,91917,88801,3.51
2024-08-06,D050,3108,90214,93322,92565,0.82
2024-08-07,D050,4094,65304,69398,65401,6.11
2024-08-08,D050,5285,83885,89170,88761,0.46
2024-08-15,D050,6055,60000,66055,67744,-2.49
2024-08-15,D050,3508,53870,57378,59052,-2.83
2024-08-29,D050,5550,88523,94073,90113,4.39
2024-08-31,D050,5737,69008,74745,72246,3.46
2024-09-11,D050,5428,87755,93183,95642,-2.57
2024-09-15,D050,3972,96698,100670,99974,0.7
2024-09-18,D050,4850,52169,57019,57847,-1.43
2024-09-20,D050,5111,91000,96111,95744,0.38
2024-09-22,D050,5196,70131,75327,77676,-3.02
2024-10-01,D050,6887,54063,60950,61696,-1.21
2024-10-02,D050,5547,77340,82887,85551,-3.11
2024-10-06,D050,4690,65524,70214,68121,3.07
2024-10-06,D050,5391,92000,97391,93952,3.66
2024-10-16,D050,3163,86078,89241,88853,0.44
2024-10-19,D050,4233,80653,84886,86133,-1.45
2024-10-20,D050,6923,89062,95985,92458,3.81
2024-10-20,D050,4929,64633,69562,67662,2.81
2024-10-31,D050,3582,52205,55787,54673,2.04
2024-11-08,D050,5377,91298,96675,97390,-0.73
2024-11-12,D050,3941,78484,82425,82752,-0.4
2024-11-16,D050,6179,82019,88198,88971,-0.87
2024-11-25,D050,4377,71657,76034,77085,-1.36
2024-12-01,D050,6587,80023,86610,85417,1.4
2024-12-02,D050,5654,55899,61553,60435,1.85
2024-12-04,D050,3567,65321,68888,67434,2.16
2024-12-05,D050,3139,96550,99689,95390,4.51
2024-12-08,D050,5549,91723,97272,92578,5.07
2024-12-08,D050,4566,91936,96502,94706,1.9
2024-12-10,D050,4433,85383,89816,91203,-1.52
2024-12-14,D050,6079,99984,106063,104655,1.35
2024-12-22,D050,6500,99691,106191,101206,4.93
2024-12-22,D050,4439,73042,77481,78220,-0.94
2024-12-23,D050,5775,95961,101736,97665,4.17
2024-12-28,D050,4820,85289,90109,91240,-1.24
